abandon	(v) bỏ, từ bỏ
ability	(n) khả năng, năng lực
able	(adj) có năng lực, có tài
about	(adv) (prep) khoảng, về
above	(adv) ở trên
abroad	(adv) ở, ra nước ngoài, ngoài trời
absence	(n) sự vắng mặt
absent	(adj) vắng mặt, nghỉ
absolute		(adj) tuyệt đối, hoàn toàn
absolutely	(adv) tuyệt đối, hoàn toàn
absorb	(v) thu hút, hấp thu, lôi cuốn
abuse	(n) (v) lộng hành, lạm dụng
academic		(adj) thuộc học viện, ĐH, viện hàn lâm
accent	(n) trọng âm, dấu trọng âm
accept	(v) chấp nhận, chấp thuận
acceptable	(adj) có thể chấp nhận, chấp thuận
access	(n) lối, cửa, đường vào
accident		(n) tai nạn, rủi ro
accidental	(adj) tình cờ, bất ngờ
accidentally	(adv) tình cờ, ngẫu nhiên
accommodation	(n) sự thích nghi, điều tiết
accompany	(v) đi theo, đi cùng, kèm theo
account	(n) (v) tài khoản, kế toán; tính toán
accurate		(adj) đúng đắn, chính xác, xác đáng
accuse	(v) tố cáo, buộc tội, kết tội
acid	(n) axit
acknowledge	(v) công nhận, thừa nhận
acquire	(v) dành được, đạt được, kiếm được
across	(adv) (prep) qua, ngang qua
activity		(n) sự tích cực, sự hoạt động, sự hăng hái
actor	(n) diễn viên nam
actual	(adj) thực tế, có thật
actually		(adv) hiện nay, hiện tại
actress	(n) diễn viên nữ
adapt	(v) tra, lắp vào
add	(v) cộng, thêm vào
additional	(adj) thêm vào, tăng thêm
address	(n) (v) địa chỉ, đề địa chỉ
adequate		(adj) đầy, đầy đủ
adjust	(v) sửa lại cho đúng, điều chỉnh
admiration	(n) sự khâm phục,người khâm phục, thán phục
admire	(v) khâm phục, thán phục
admit	(v) nhận vào, cho vào, kết hợp
adopt	(v) nhận làm con nuôi, bố mẹ nuôi
adult	(n) (adj) người lớn, người trưởng thành;
advance	(n) (v) sự tiến bộ, tiến lên; đưa lên, đề xuất
advantage	(n) sự thuận lợi, lợi ích, lợi thế
adventure	(n) sự phiêu lưu, mạo hiểm
advertise	(v) báo cho biết, báo cho biết trước
advertisement	(n) quảng cáo
advice	(n) lời khuyên, lời chỉ bảo
advise	(v) khuyên, khuyên bảo, răn bảo
affair	(n) việc
affect	(v) làm ảnh hưởng, tác động đến
affection	(n) tình cảm, cảm xúc
afford	(v) có thể, có đủ khả năng, điều kiện (làm gì)
afraid	(adj) sợ, sợ hãi, hoảng sợ
after	(prep) (conj) sau, đằng sau, sau khi
afternoon	(n) buổi chiều
afterwards	(adv) sau này, về sau, rồi thì, sau đấy
age	(n) tuổi
agency	(n) tác dụng, lực; môi giới, trung gian
agent	(n) đại lý, tác nhân
aggressive	(adj) xâm lược, hung hăng (US: xông xáo)
ago	(adv) trước đây
ahead	(adv) trước, về phía trước
aim	(n) (v) sự nhắm (bắn), mục tiêu, ý định; nhắm, tập trung, hướng vào
air	(n) không khí, bầu không khí, không gian
aircraft		(n) máy bay, tàu bay, khí cầu
alarm	(n) (v) báo động, báo nguy
alcohol	(n) rừợu cồn
alive	(adj) sống, vẫn còn sống, còn tồn tại
all	(n) (adv) tất cả
alone	(adj) (adv) cô đơn, một mình
alongside	(prep) (adv) sát cạnh, kế bên, dọc theo
aloud	(adv) lớn tiếng, to tiếng
already	(adv) đã, rồi, đã… rồi
also	(adv) cũng, cũng vậy, cũng thế
alter	(v) thay đổi, biến đổi, sửa đổi
alternative	(n) (adj) sự lựa chọn; lựa chọn
altogether	(adv) hoàn toàn, hầu như; nói chung
always	(adv) luôn luôn
amaze	(v) làm ngạc nhiên, làm sửng sốt
ambition		(n) hoài bão, khát vọng
ambulance	(n) xe cứu thương, xe cấp cứu
among	(prep) giữa, ở giữa
amount	(n) (v) số lượng, số nhiều; lên tới (money)
amuse	(v) làm cho vui, thích, làm buồn cười,thích thú
analysis		(n) sự phân tích
ancient	(adj) xưa, cổ
and	(conj) và
angry	(adj) giận, tức giận
approve	(v) tán thành, đồng ý, chấp thuận
approximate	(+to) (adj) giống với, giống hệt với
area	(n) diện tích, bề mặt
argue	(v) tranh luận
argument		(n) lý lẽ
arise	(v) xuất hiện, nảy ra, nảy sinh ra
arm	(n) (v) cánh tay; vũ trang, trang bị (vũ khí)
army	(n) quân đội
around	(adv, prep.)xung quanh, vòng quanh
arrange	(v) sắp xếp, sắp đặt, sửa soạn
arrangement	(n) sự sắp xếp, sắp đặt, sự sửa soạn
arrest	(v) (n) bắt giữ, sự bắt giữ
arrival	(n) sự đến, sự tới nơi
arrive	(+at, in) (v) đến, tới nơi
arrow	(n) tên, mũi tên
art	(n) nghệ thuật, mỹ thuật
article	(n) bài báo, đề mục
artificial	(adj) nhân tạo
artist	(n) nghệ sĩ
artistic		(adj) thuộc nghệ thuật, thuộc mỹ thuật
as	(prep,adv, conj.) như
ashamed	(adj) ngượng, xấu hổ
aside	(adv) về một bên, sang một bên
asleep	(adj) ngủ, đang ngủ
aspect	(n) vẻ bề ngoài, diện mạo
assist	(v) giúp, giúp đỡ; tham dự, có mặt
assistance	(n) sự giúp đỡ
assistant	(n) (adj) người giúp đỡ, người phụ tá; giúp đỡ
associate	(v) kết giao, liên kết, kết hợp, cho cộng tác
assume	(v) mang, khoác, có, lấy (cái vẻ, tính chất…)
assure	(v) đảm bảo, cam đoan
atmosphere	(n) khí quyển
atom	(n) nguyên tử
attach	(v) gắn, dán, trói, buộc
attempt	(n) (v) sự cố gắng, sự thử; cố gắng, thử
attend	(v) dự, có mặt
attention	(n) sự chú ý
attitude		(n) thái độ, quan điểm
attorney		(n) người được ủy quyền
attract	(v) hút; thu hút, hấp dẫn
attraction	(n) sự hút, sức hút
attractive	(adj) hút, thu hút, có duyên, lôi cuốn
audience		(n) thính, khan giả
aunt	(n) cô, dì
automatic	(adj) tự động
autumn	(n) mùa thu (US: mùa thu là fall)
available	(adj) có thể dùng được, có giá trị, hiệu lực
average	adj., (n) trung bình, số trung bình, mức trung bình
avoid	(v) tránh, tránh xa
awake	(adj) đánh thức, làm thức dậy
award	(n) (v) phần thưởng; tặng, thưởng
aware	(adj) biết, nhận thức, nhận thức thấy
away	(adv) xa, xa cách, rời xa, đi xa
awful	(adj) oai nghiêm, dễ sợ
awkward	(adj) vụng về, lung túng
back	(n)adj., (adv)., (v) lưng, về phía sau, trở lại
background	(n) phía sau; nền
backward		(adj) về phía sau, lùi lại
bacteria		(n) vi khuẩn
bad	(adj) xấu, tồi
bag	(n) bao, túi, cặp xách
baggage	(n) hành lý
bake	(v) nung, nướng bằng lò
balance	(n) (v) cái cân; làm cho cân bằng, tương xứng
ball	(n) quả bóng
band	(n) băng, đai, nẹp
bandage	(n) (v) dải băng; băng bó
bank	(n) bờ (sông…) , đê
bar	(n) quán bán rượu
bargain	(n) sự mặc cả, sự giao kèo mua bán
barrier	(n) đặt chướng ngại vật
base	(n) (v) cơ sở, cơ bản, nền móng; đặt tên, đặt cơ sở trên cái gì
basic	(adj) cơ bản, cơ sở
basis	(n) nền tảng, cơ sở
battery	(n) pin, ắc quy
battle	(n) trận đánh, chiến thuật
bath	(n) sự tắm
bay	(n) gian (nhà), nhịp (cầu), chuồng (ngựa); bays: vòng nguyệt quế
beach	(n) bãi biển
bear	(v) mang, cầm, vác, đeo, ôm
beard	(n) râu
beat	(n) (v) tiếng đập, sự đập; đánh đập, đấm
beautiful	(adj) đẹp
beauty	(n) vẻ đẹp, cái đẹp; người đẹp
because	(conj) bởi vì, vì
become	(v) trở thành, trở nên
bed	(n) cái giường
bedroom	(n) phòng ngủ
beef	(n) thịt bò
beer	(n) rượu bia
before	prep., conj., (adv) trước, đằng trước
begin	(v) bắt đầu, khởi đầu
behalf	(n) sự thay mặt
behave	(v) đối xử, ăn ở, cư xử
behaviour	(n) cách đối xử, cách ăn ở,tư cách đạo đức
behind	(prep) (adv) sau, ở đằng sau
believe	(v) tin, tin tưởng
bell	(n) cái chuông, tiếng chuông
belong	(v) thuộc về, của, thuộc quyền sở hữu
below	(prep) (adv) ở dưới, dưới thấp, phía dưới
belt	(n) dây lưng, thắt lưng
bend	(v) (n) chỗ rẽ, chỗ uốn; khuỷu tay; cúi xuống, uốn cong
beneath	(prep) (adv) ở dưới, dưới thấp
benefit	(n) (v) lợi, lợi ích; giúp ích, làm lợi cho
beside	(prep) bên cạnh, so với
bet	(v) (n) đánh cược, cá cược; sự đánh cược
between	(prep) (adv) giữa, ở giữa
beyond	(prep) (adv) ở xa, phía bên kia
bicycle	(n) xe đạp
bid	(v) (n) đặt giá, trả giá; sự đặt giá, sự trả giá
big	(adj) to, lớn
bill	(n) hóa đơn, giấy bạc
bin	(n) thùng, thùng đựng rượu
biology	(n) sinh vật học
bird	(n) chim
birth	(n) sự ra đời, sự sinh đẻ
birthday		(n) ngày sinh, sinh nhật
biscuit	(n) bánh quy
bit	(n) miếng, mảnh
bite	(v) (n) cắn, ngoạm; sự cắn, sự ngoạm
bitter	(adj) đắng; đắng cay, chua xót
black	(adj) (n) đen; màu đen
blade	(n) lưỡi (dao, kiếm); lá (cỏ, cây); mái (chèo); cánh (chong chóng)
blame	(v) (n) khiển trách, mắng trách; sự khiển trách, sự mắng trách
blank	(adj) (n) trống, để trắng; sự trống rỗng
blind	(adj) đui, mù
block	(n) (v) khối, tảng (đá); làm ngăn cản, ngăn chặn
blond	(adj) vàng hoe
blood	(n) máu, huyết; sự tàn sát, chém giết
blow	(v) (n) nở hoa; sự nở hoa
blue	(adj) (n) xanh, màu xanh
board	(n) (v) tấm ván; lát ván, lót ván
boat	(n) tàu, thuyền
body	(n) thân thể, thân xác
boil	(v) sôi, luộc
bomb	(n) (v) quả bom; đánh bom, thả bom
bone	(n) xương
book	(n) (v) sách; ghi chép
boot	(n) khởi động
border	(n) bờ, mép, vỉa, lề (đường)
bore	(n) khoan
bored	(adj) buồn chán
born	(v) sinh, đẻ
borrow	(v) vay, mượn
boss	(n) ông chủ, thủ trưởng
bottle	(n) chai, lọ
bottom	(n) (adj) phần dưới cùng, thấp nhất; cuối, cuối cùng
both	det., pro(n) cả hai
bother	(v) làm phiền, quấy rầy, làm bực mình
bound	(+to) (adj) nhất định, chắc chắn
bowl	(n) cái bát
box	(n) hộp, thùng
brain	(n) óc não; đầu óc, trí não
branch	(n) ngành; nhành cây, nhánh song, ngả đường
brand	(n) nhãn (hàng hóa)
brave	(adj) gan dạ, can đảm
bread	(n) bánh mỳ
break	(v) (n) bẻ gãy, đập vỡ; sự gãy, sự vỡ
breakfast	(n) bữa điểm tâm, bữa sáng
breath	(n) hơi thở, hơi
breathe	(v) hít, thở
breed	(v) (n) nuôi dưỡng, chăm sóc, giáo dục; sinh đẻ; nòi giống
brick	(n) gạch
bridge	(n) cái cầu
brief	(adj) ngắn, gọn, vắn tắt
brilliant	(adj) tỏa sáng, rực rỡ, chói lọi
bring	(v) mang, cầm , xách lại
broad	(adj) rộng
broadcast	(v) (n) tung ra khắp nơi,truyền rộng rãi; phát thanh,quảng bá
brown	(adj) (n) nâu, màu nâu
brush	(n) (v) bàn chải; chải, quét
bubble	(n) bong bóng, bọt, tăm
build	(v) xây dựng
bullet	(n) đạn (súng trường, súng lục)
bunch	(n) búi, chùm, bó, cụm, buồng; bầy, đàn
burn	(v) đốt, đốt cháy, thắp, nung, thiêu
bury	(v) chôn cất, mai táng
bush	(n) bụi cây, bụi rậm
business		(n) việc buôn bán, thương mại, kinh doanh
busy	(adj) bận, bận rộn
butter	(n) bơ
button	(n) cái nút, cái khuy, cúc
buy	(v) mua
buyer	(n) người mua
by	(prep) (adv) bởi, bằng
cabinet	(n) tủ có nhiều ngăn đựng đồ
cable	(n) dây cáp
cake	(n) bánh ngọt
calculate	(v) tính toán
calculation	(n) sự tính toán
call	(v) (n) gọi; tiếng kêu, tiếng gọi
calm	(adj) (v) (n) yên lặng, làm dịu đi; sự yên lặng, sự êm ả
campaign		(n) chiến dịch, cuộc vận động
can	(v) (n) có thể; nhà tù, nhà giam, bình, ca đựng
cancel	(v) hủy bỏ, xóa bỏ
cancer	(n) bệnh ung thư
candidate	(n) người ứng cử, thí sinh, người dự thi
candy	(n) kẹo
cap	(n) mũ lưỡi trai, mũ vả
capacity		(n) năng lực, khả năng tiếp thu, năng suất
capital	(n) (adj) thủ đô, tiền vốn; chủ yếu, chính yếu, cơ bản
captain	(n) người cầm đầu, người chỉ huy, thủ lĩnh
capture	(v) (n) bắt giữ, bắt; sự bắt giữ, sự bị bắt
card	(n) thẻ, thiếp
cardboard	(n) bìa cứng, các tông
care	(n) (v) sự chăm sóc, chăm nom; chăm sóc
career	(n) nghề nghiệp, sự nghiệp
careful	(adj) cẩn thận, cẩn trọng, biết giữ gìn
careless		(adj) sơ suất, cầu thả
carpet	(n) tấm thảm, thảm (cỏ)
carrot	(n) củ cà rốt
carry	(v) mang, vác, khuân chở
case	(n) vỏ, ngăn, túi
cash	(n) tiền, tiền mặt
cast	(v) (n) quăng, ném, thả, đánh gục; sự quăng, sự ném (lưới), sự thả (neo)
castle	(n) thành trì, thành quách
catch	(v) bắt lấy, nắm lấy, tóm lấy, chộp lấy
category		(n) hạng, loại; phạm trù
cause	(n) (v) nguyên nhân, nguyên do; gây ra, gây nên
cease	(v) dừng, ngừng, ngớt, thôi, hết, tạnh
ceiling	(n) trần nhà
celebrate	(v) kỷ niệm, làm lễ kỷ niệm; tán dương, ca tụng
celebration	(n) sự kỷ niệm, lễ kỷ niệm; sự tán dương, sự ca tụng
cell	(n) ô, ngăn
cent	(n) đồng xu
centimeter	(n) xen ti met
century	(n) thế kỷ
ceremony		(n) nghi thức, nghi lễ
certain	(adj),pro(n) chắc chắn
certificate	(n) giấy chứng nhận, bằng, chứng chỉ
cigarette	(n) điếu thuốc lá
cinema	(n) rạp chiếu bóng
circle	(n) đường tròn, hình tròn
circumstance	(n) hoàn cảnh, trường hợp, tình huống
citizen	(n) người thành thị
city	(n) thành phố
civil	(adj) (thuộc) công dân
claim	(v) (n) đòi hỏi, yêu sách; sự đòi hỏi, sự yêu sách, sự thỉnh cầu
clap	(v) (n) vỗ, vỗ tay; tiếng nổ, tiếng vỗ tay
classic	(adj) (n) cổ điển, kinh điển
clean	(adj) (v) sạch, sạch sẽ
clear	(adj) (v) lau chùi, quét dọn
clerk	(n) thư ký, linh mục, mục sư
client	(n) khách hàng
climate	(n) khí hậu, thời tiết
climb	(v) leo, trèo
clock	(n) đồng hồ
close	(v) (adj) gần (mqh), thân thiết,chặt chẽ, đóng, khép, kết thúc
closet	(n) buồng, phòng để đồ, phòng kho
cloth	(n) vải, khăn trải bàn, áo thầy tu
cloud	(n) mây, đám mây
club	(n) câu lạc bộ; gậy, dùi cui
coach	(n) huấn luyện viên
coal	(n) than đá
coast	(n) sự lao dốc; bờ biển
coat	(n) áo choàng
code	(n) mật mã, luật, điều lệ
coin	(n) tiền kim loại
cold	(adj) (n) lạnh, sự lạnh lẽo, lạnh nhạt
coldly	(adv) lạnh nhạt, hờ hững, vô tâm
collapse		(v) (n) đổ, sụp đổ; sự đổ nát, sự sụp đổ
colleague	(n) bạn đồng nghiệp
collect	(v) sưu tập, tập trung lại
collection	(n) sự sưu tập, sự tụ họp
college	(n) trường cao đẳng
color	(n) Màu sắc
column	(n) cột , mục (báo)
combination	(n) sự kết hợp, sự phối hợp
combine	(v) kết hợp, phối hợp
comedy	(n) hài kịch
comfort	(n) (v) sự an ủi, khuyên giải, lời động viên, sự an nhàn
comfortable	(adj) thoải mái, tiện nghi, đầy đủ
comfortably	(adv) dễ chịu, thoải mái, tiện nghi, ấm cúng
command	(v) (n) ra lệnh, chỉ huy; lệnh, mệnh lệnh, quyền ra lệnh, quyền chỉ huy
comment	(n) (v) lời bình luận, lời chú giải; bình luận, phê bình, chú thích, dẫn giải
commercial	(adj) buôn bán, thương mại
commission	(n) (v) hội đồng, ủy ban, sự ủy nhiệm, sự ủy thác,
commit	(v) giao, gửi, ủy nhiệm, ủy thác; tống giam, bỏ tù
commitment	(n) sự phạm tội, sự tận tụy, tận tâm
committee	(n) ủy ban
common	(adj) công, công cộng, thông thường, phổ biến
communicate	(v) truyền, truyền đạt; giao thiệp, liên lạc
communication	(n) sự giao tiếp, liên lạc, sự truyền đạt, truyền tin
community	(n) dân chúng, nhân dân
company	(n) công ty
compare	(v) so sánh, đối chiếu
comparison	(n) sự so sánh
compete	(v) đua tranh, ganh đua, cạnh tranh
competition	(n) sự cạnh tranh, cuộc thi, cuộc thi đấu
competitive	(adj) cạnh tranh, đua tranh
complain		(v) phàn nàn, kêu ca
complaint	(n) lời than phiền, than thở; sự khiếu nại, đơn kiện
complete		(adj) (v) hoàn thành, xong
complex	(adj) phức tạp, rắc rối
complicate	(v) làm phức tạp, rắc rối
computer		(n) máy tính
concentrate	(v) tập trung
concept	(n) khái niệm
concern	(v) (n) liên quan, dính líu tới; sự liên quan, sự dính líu tới
concert	(n) buổi hòa nhạc
conclude		(v) kết luận, kết thúc, chấm dứt (công việc)
conclusion	(n) sự kết thúc, sự kết luận, phần kết luận
concrete		adj., (n) bằng bê tông; bê tông
condition	(n) điều kiện, tình cảnh, tình thế
conduct	(v) (n) điều khiển, chỉ đạo, chỉ huy; sự điều khiển, chỉ huy
conference	(n) hội nghị, sự bàn bạc
confidence	(n) lòng tin tưởng, sự tin cậy
confident	(adj) tin tưởng, tin cậy, tự tin
confine	(v) giam giữ, hạn chế
confirm	(v) xác nhận, chứng thực
conflict		(n) (v) xung đột, va chạm; sự xung đột, sự va chạm
confront		(v) đối mặt, đối diện, đối chiếu
confuse	(v) làm lộn xộn, xáo trộn
confusion	(n) sự lộn xộn, sự rối loạn
connect	(v) kết nối, nối
connection	(n) sự kết nối, sự giao kết
conscious	(adj) tỉnh táo, có ý thức, biết rõ
consequence	(n) kết quả, hậu quả
conservative	(adj) thận trọng, dè dặt, bảo thủ
consider		(v) cân nhắc, xem xét; để ý, quan tâm, lưu ý đến
considerable	(adj) lớn lao, to tát, đáng kể
considerably	(adv) đáng kể, lớn lao, nhiều
consideration	(n) sự cân nhắc, sự xem xét, sự để ý, sự quan tâm
consist	(v) (+of) gồm có
constant		(adj) kiên trì, bền lòng
constantly	(adv) kiên định
construct	(v) xây dựng
construction	(n) sự xây dựng, công trình
consult	(v) tra cứu, tham khảo, thăm dò, hỏi ý kiến
consumer		(n) người tiêu dùng
contact	(n) (v) sự liên lạc, sự giao thiệp; tiếp xúc
contain	(v) bao hàm, chứa đựng, bao gồm
container	(n) cái đựng, chứa; công te nơ
contemporary	(adj) đương thời, đương đại
content	(n) nội dung, sự hài lòng
contest	(n) cuộc thi, trận đấu, cuộc tranh luận, cuộc chiến đấu,chiến tranh
context	(n) văn cảnh, khung cảnh, phạm vi
continent	(n) lục địa, đại lục
continue		(v) tiếp tục, làm tiếp
continuous	(adj) liên tục, liên tiếp
contract		(n) (v) hợp đồng, sự ký hợp đồng; ký kết
contrast		(n) (v) sự tương phản; làm tương phản, trái ngược
contribute	(v) đóng góp, góp phần
contribution	(n) sự đóng góp, sự góp phần
control	(n) (v) sự điều khiển, quyền hành, quyền lực, quyền chỉ huy
convenient	(adj) tiện lợi, thuận lợi, thích hợp
convention	(n) hội nghị, hiệp định, quy ước
conventional	(adj) quy ước
convert	(v) đổi, biến đổi
convince		(v) làm cho tin, thuyết phục; làm cho nhận thức thấy
cook	(v) (n) nấu ăn, người nấu ăn
cookie	(n) bánh quy
cool	(adj) (v) mát mẻ, điềm tĩnh; làm mát
cope	(v + with) đối phó, đương đầu
copy	(n) (v) bản sao, bản chép lại; sự sao chép; sao chép, bắt chước
core	(n) nòng cốt, hạt nhân; đáy lòng
corner	(n) góc (tường, nhà, phố...)
correct	(adj) (v) đúng, chính xác; sửa, sửa chữa
cost	(n) (v) giá, chi phí; trả giá, phải trả
cottage	(n) nhà tranh
cotton	(n) bông, chỉ, sợi
cough	(v) (n) ho, sự ho, tiếng hoa
council	(n) hội đồng
count	(v) đếm, tính
counter	(n) quầy hàng, quầy thu tiền, máy đếm
county	(n) hạt, tỉnh
country	(n) nước, quốc gia, đất nước
countryside	(n) miền quê, miền nông thôn
couple	(n) đôi, cặp
course	(n) tiến trình, quá trình diễn tiến; sân chạy đua
court	(n) sân, sân (tennis...), tòa án, quan tòa, phiên tòa
cousin	(n) anh em họ
cover	(v) (n) bao bọc, che phủ; vỏ, vỏ bọc
cow	(n) con bò cái
crack	(n) (v) cừ, xuất sắc; làm nứt, làm vỡ, nứt nẻ, rạn nứt
craft	(n) nghề, nghề thủ công
crash	(n) (v) vải thô; sự rơi (máy bay), sự phá sản, sụp đổ; phá tan tành
crazy	(adj) điên, mất trí
cream	(n) kem
create	(v) sáng tạo, tạo nên
creature		(n) sinh vật, loài vật
credit	(n) sự tin, lòng tin, danh tiếng; tiền gửi ngân hàng
crime	(n) tội, tội ác, tội phạm
criminal		(adj) (n) có tội, phạm tội; kẻ phạm tội, tội phạm
crisis	(n) sự khủng hoảng, cơn khủng hoảng
crisp	(adj) giòn
criterion	(n) tiêu chuẩn
critical		(adj) phê bình, phê phán; khó tính
criticism	(n) sự phê bình, sự phê phán, lời phê bình, lời phê phán
criticize	(v) phê bình, phê phán, chỉ trích
crop	(n) vụ mùa
cross	(n) (v) cây Thánh Giá, nỗi thống khổ; sự băng qua; băng qua, vượt qua
crowd	(n) đám đông
crown	(n) vương miện, vua, ngai vàng; đỉnh cao nhất
crucial	(adj) quyết định, cốt yếu, chủ yếu
cruel	(adj) độc ác, dữ tợn, tàn nhẫn
crush	(v) ép, vắt, đè nát, đè bẹp
cry	(v) (n) khóc, kêu la; sự khóc, tiếng khóc, sự kêu la
culture	(n) văn hóa, sự mở mang, sự giáo dục
cup	(n) tách, chén
cupboard		(n) 1 loại tủ có ngăn
curb	(v) kiềm chế, nén lại, hạn chế
cure	(v) (n) chữa trị, điều trị; cách chữa bệnh, cách điều trị; thuốc
curious	(adj) ham muốn, tò mò, lạ lùng
curl	(v) (n) quăn, xoắn, uốn quăn, làm xoắn; sự uốn quăn
curly	(adj) quăn, xoắn
custom	(n) phong tục, tục lệ, thói quen, tập quán
cut	(v) (n) cắt, chặt; sự cắt
cycle	(n) (v) chu kỳ, chu trình, vòng; quay vòng theo chu kỳ, đi xe đạp
cycling	(n) sự đi xe đạp
chair	(n) ghế
chairman		(n) chủ tịch, chủ tọa
challenge	(n) (v) sự thử thách, sự thách thức; thách thức, thử thách
chamber	(n) buồng, phòng, buồng ngủ
chance	(n) sự may mắn
channel	(n) kênh (TV, radio), eo biển
change	(v) (n) thay đổi, sự thay đổi, sự biến đổi
chapter	(n) chương (sách)
character	(n) tính cách, đặc tính, nhân vật
charity	(n) lòng từ thiện, lòng nhân đức; sự bố thí
chart	(n) (v) đồ thị, biểu đồ; vẽ đồ thị, lập biểu đồ
chase	(v) (n) săn bắt; sự săn bắt
chat	(v) (n) nói chuyện, tán gẫu; chuyện phiếm, chuyện gẫu
cheap	(adj) rẻ
cheat	(v) (n) lừa, lừa đảo; trò lừa đảo, trò gian lận
check	(v) (n) kiểm tra; sự kiểm tra
cheek	(n) má
cheerful		(adj) vui mừng, phấn khởi, hồ hởi
cheese	(n) pho mát
chemical		(adj) (n) thuộc hóa học; chất hóa học, hóa chất
chemist	(n) nhà hóa học
chemistry	(n) hóa học, môn hóa học, ngành hóa học
cheque	(n) séc
chest	(n) tủ, rương, hòm
chew	(v) nhai, ngẫm nghĩ
chicken	(n) gà, gà con, thịt gà
chief	(adj) (n) trọng yếu, chính yếu; thủ lĩnh, lãnh tụ, người đứng đầu, sếp
child	(n) đứa bé, đứa trẻ
chin	(n) cằm
chip	(n) vỏ bào, mảnh vỡ, chỗ sứt, mẻ
choice	(n) sự lựa chọn
choose	(v) chọn, lựa chọn
daily	(adj) hàng ngày
damage	(n) (v) mối hại, điều hại, sự thiệt hại; làm hư hại, làm hỏng
dance	(n) (v) sự nhảy múa, sự khiêu vũ; nhảy múa, khiêu vũ
dancer	(n) diễn viên múa, người nhảy múa
dangert(n) sự nguy hiểm, mối hiểm nghèo; nguy cơ, mối đe dọa
dangeroust(adj) nguy hiểm
daret(v) dám, dám đương đầu với; thách
darkt(adj) (n) tối, tối tăm; bóng tối, ám muội
datat(n) số liệu, dữ liệu
datet(n) (v) ngày, kỳ, kỳ hạn, thời kỳ
daughter	t(n) con gái
dayt(n) ngày, ban ngày
deadt(adj) chết, tắt
deaft(adj) điếc, làm thinh, làm ngơ
deart(adj) thân, thân yêu, thân mến; kính thưa, thưa
death t(n) sự chết, cái chết
debtt(n) nợ
decadet(n) thập kỷ, bộ mười, nhóm mười
decay t(n) (v) tình trạng suy tàn, suy sụp, tình trạng đổ nát
december	t(n)tháng mười hai, tháng Chạp
decidet(v) quyết định, giải quyết, phân xử
decision	t(n) sự quyết định, sự giải quyết, sự phân xử
declare t(v) tuyên bố, công bố
decorate	t(v) trang hoàng, trang trí
decoration t(n) sự trang hoàng, đồ trang hoàng, trang trí
decorative t(adj) để trang hoàng, để trang trí, để làm cảnh
decrease	t(v) (n) giảm bớt, làm suy giảm, sự giảm đi, sự giảm sút
deept(adj) (adv) sâu, khó lường, bí ẩn
defeatt(v) (n) đánh bại, sự thất bại
defendt(v) che chở, bảo vệ, bào chữa
definet(v) định nghĩa
definite	t(adj) xác định, định rõ, rõ ràng
definition t(n) sự định nghĩa, lời định nghĩa
degreet(n) mức độ, trình độ; bằng cấp; độ
delay t(n) (v) sự chậm trễ, sự trì hoãn, sự cản trở; làm chậm trễ
deliberate t(adj) thận trọng, có tính toán, chủ tâm, có suy nghĩ cân nhắc
delicate	t(adj) thanh nhã, thanh tú, tế nhị, khó xử
delight t(n) (v) sự vui thích, sự vui sướng
deliver t(v) cứu khỏi, thoát khỏi, bày tỏ, giãi bày
delivery	t(n) sự phân phát, sự phân phối
demandt(n) (v) sự đòi hỏi, sự yêu cầu; đòi hỏi, yêu cầu
demonstratet(v) chứng minh, giải thích; bày tỏ, biểu lộ
dentist t(n) nha sĩ
denyt(v) từ chối, phản đối, phủ nhận
department t(n) cục, sở, ty, ban, khoa; gian hàng, khu bày hàng
departuret(n) sự rời khỏi, sự đi, sự khởi hành
dependt(v) phụ thuộc, tùy thuộc; dựa vào, ỷ vào, trông mong vào
deposit t(n) (v) vật gửi, tiền gửi, tiền đặt cọc; gửi, đặt cọc
depress t(v) làm chán nản, làm phiền muộn; làm suy giảm
depth t(n) chiều sâu, độ dày
derivet(v) nhận được từ, lấy được từ;
descriptiont(n) sự mô tả, sự tả, sự miêu tả
desertt(n) sa mạc; công 
deserve t(v) đáng, xứng đáng
designt(n) (v) sự thiết kế, kế hoạch, đề cương. phác thảo
desiret(n) (v) ước muốn; thèm muốn, ao ước
deskt(n) bàn (học sinh, viết, làm việc)
destroy t(v) phá, phá hoại, phá huỷ, tiêu diệt, triệt phá
destructiont(n) sự phá hoại, sự phá hủy, sự tiêu diệt
detailt(n) (v) chi tiết
determination t(n) sự xác định, sự định rõ; sự quyết định
determinet(v) xác định, định rõ; quyết định
determined t(adj) đã được xác định, đã được xác định rõ
develop t(v) phát triển, mở rộng; trình bày, bày tỏ
developmentt(n) sự phát triển, sự trình bày, sự bày tỏ
devicet(n) kế sách; thiết bị, dụng cụ, máy móc
devotet(v) hiến dâng, dành hết cho
diagram t(n) biểu đồ
diamond t(n) kim cương
diary t(n) sổ nhật ký; lịch ghi nhớ
dictionary t(n) từ điển
diet(v) chết, từ trần, hy sinh
diett(n) chế độ ăn uống, chế độ ăn kiêng
difference t(n) sự khác nhau
differentt(adj) khác, khác biệt, khác nhau
difficultt(adj) khó, khó khăn, gay go
digt(v) đào bới, xới
dinnert(n) bữa trưa, chiều
directt(adj) trực tiếp, thẳng, thẳng thắn
directiont(n) sự điều khiển, sự chỉ huy
director	t(n) giám đốc, người điều khiển, chỉ huy
dirtt(n) đồ bẩn thỉu, đồ dơ bẩn, vật rác rưởi
disadvantaget(n) sự bất lợi, sự thiệt hại
disagree	t(v) bất đồng, không đồng ý, khác, không giống; không hợp
disagreementt(n) sự bất đồng, sự không đồng ý, sự khác nhau
disappeart(v) biến mất, biến đi
disappoint t(v) không làm thỏa ước nguyện,
disappointmentt(n) sự chán ngán, sự thất vọng
disapprove t(v) không tán thành, phản đối, chê
disaster	t(n) tai họa, thảm họa
discipline t(n) kỷ luật
discount	t(n) sự bớt giá, sự chiết khấu, tiền bớt, chiết khấu
discover	t(v) khám phá, phát hiện ra, nhận ra
discoveryt(n) sự khám phá, sự tìm ra, sự phát hiện ra
discuss t(v) thảo luận, tranh luận
discussion t(n) sự thảo luận, sự tranh luận
disease t(n) căn bệnh, bệnh tật
disgust t(v) (n) làm ghê tởm, làm kinh tởm, làm phẫn nộ
dishonestt(adj) bất lương, không thành thật
diskt(n) đĩa, đĩa hát
dislike t(v) (n) sự không ưa, không thích, sự ghét
dismiss t(v) giải tán (quân đội, đám đông); sa thải (người làm)
display t(v) (n) bày tỏ, phô trương, trưng bày; sự bày ra, phô bày,trưng bày
dissolve	t(v) tan rã, phân hủy, giải tán
distance	t(n) khoảng cách, tầm xa
distinguisht(v) phân biệt, nhận ra, nghe ra
disturb t(v) làm mất yên tĩnh, làm náo động, quấy rầy
dividet(v) chia, chia ra, phân ra
division	t(n) sự chia, sự phân chia, sự phân loại
divorce t(n) (v) sự ly dị
doctort(n) bác sĩ y khoa, tiến sĩ
document	t(n) văn kiện, tài liệu, tư liệu
dollart(n) đô la Mỹ
domestic	t(adj) vật nuôi trong nhà, (thuộc) nội trợ, quốc nội
dominate	t(v) chiếm ưu thế, có ảnh hưởng, chi phối; kiềm chế
doort(n) cửa, cửa ra vào
dott(n) chấm nhỏ, điểm; của hồi môn
doublet(adj) (adv) (n) (v) đôi, hai, kép; cái gấp đôi, lượng gấp đôi; làm gấp đôi
doubt t(n) (v) sự nghi ngờ, sự ngờ vực; nghi ngờ, ngờ vực
downt(adv) (prep) xuống
downstairs t(adv) (adj) (n) ở dưới nhà, ở tầng dưới
downward	t(adj) xuống, đi xuống
downwardst(adv) xuống, đi xuống
dozen t(n)det. tá (12)
draft t(n) (adj) (v) bản phác thảo, sơ đồ thiết kế; phác thảo, thiết kế
dragt(v) lôi kéo, kéo lê
drama t(n) kịch, tuồng
dramatic	t(adj) như kịch, như đóng kịch, thích hợp với sân khấu
drawt(v) vẽ, kéo
drawert(n) người vẽ, người kéo
dream t(n) (v) giấc mơ, mơ
dress t(n) (v) váy, quần áo, mặc (quần áo), ăn mặc
drink t(n) (v) đồ uống; uống
drive t(v) (n) lái , đua xe; cuộc đua xe (điều khiển)
drivert(n) người lái xe
dropt(v) (n) chảy nhỏ giọt, rơi, rớt; giọt (nước, máu...)
drugt(n) thuốc, dược phẩm; ma túy
drugstoret(n) hiệu thuốc, cửa hàng dược phẩm
drumt(n) cái trống, tiếng trống
drunk t(adj) say rượu
dryt(adj) (v) khô, cạn; làm khô, sấy khô
duet(adj) đến kỳ hạn (trả nợ); xứng đáng, thích đáng
dullt(adj) chậm hiểu, ngu đần
dumpt(v) (n) đổ rác; đống rác, nơi đổ rác
duringt(prep) trong lúc, trong thời gian
dustt(n) (v) bụi, rác; rắc (bụi, phấn), quét bụi, phủi bụi
dutyt(n) sự tôn kính, kính trọng; bồn phận, trách nhiệm
eachtpro(n) mỗi
each other tpro(n) nhau, lẫn nhau
eart(n) tai
early t(adj) (adv) sớm
earnt(v) kiếm (tiền), giành (phần thưởng)
earth t(n) đất, trái đất
easet(n) (v) sự thanh thản, sự thoải mái; làm thanh thản, làm yên tâm
eastt(n) (adj) (adv) hướng đông, phía đông, (thuộc) đông, ở phía đông
eastern t(adj) đông
easyt(adj) dễ dàng, dễ tính, ung dung
easilyt(adv) dễ dàng
eatt(v) ăn
economic	t(adj) (thuộc) Kinh tế
economy t(n) sự tiết kiệm, sự quản lý kinh tế
edget(n) lưỡi, cạnh sắc (dao)
edition t(n) nhà xuất bản, sự xuất bản
editort(n) người thu thập và xuất bản, chủ bút
educate t(v) giáo dục, cho ăn học; rèn luyện
educated	t(adj) được giáo dục, được đào tạo
educationt(n) sự giáo dục, sự rèn luyện (kỹ năng)
effectt(n) hiệu ứng, hiệu quả, kết quả
effectivet(adj) có kết quả, có hiệu lực
effectivelyt(adv) có kết quả, có hiệu lực
efficientt(adj) có hiệu lực, có hiệu quả
efficientlyt(adv) có hiệu quả, hiệu nghiệm
effortt(n) sự cố gắng, sự nỗ lực
eggt(n) trứng
eithert(adv) mỗi, một; cũng phải thế
elbow t(n) khuỷu tay
elderly t(adj) có tuổi, cao tuổi
elect t(v) bầu, quyết định
election	t(n) sự bầu cử, cuộc tuyển cử
electric	t(adj) (thuộc) điện, có điện, phát điện
electrical t(adj) (thuộc) điện
electricityt(n) điện, điện lực; điện lực học
electronic t(adj) (thuộc) điện tử
elegant t(adj) thanh lịch, tao nhã
element t(n) yếu tố, nguyên tố
elevator	t(n) máy nâng, thang máy
elsetkhác, nữa; nếu không
elsewheret(adv) ở một nơi nào khác
embarrasst(v) lúng túng, làm ngượng nghịu; làm rắc rối, gây khó khăn
embarrassingt(adj) làm lúng túng, ngăn trở
embarrassedt(adj) lúng túng, bối rối, ngượng; mang nợ
embarrassment t(n) sự lúng túng, sự bối rối
emerget(v) nổi lên, hiện ra; nổi bật lên
emergencyt(n) tình trạng khẩn cấp
emotion t(n) sự xúc động, sự cảm động, mối xúc cảm
emotionalt(adj) cảm động, xúc động, xúc cảm; dễ cảm động, dễ xúc cảm
emotionallyt(adv) xúc động
emphasis	t(n) sự nhấn mạnh, tầm quan trọng
emphasizet(v) nhấn mạnh, làm nổi bật
empiret(n) đế chế, đế quốc
employt(v) dùng, thuê ai làm gì
unemployed t(adj) thất nghiệp; không dùng, không sử dụng được
employee	t(n) người lao động, người làm công
employer	t(n) chủ, người sử dụng lao động
employment t(n) sự thuê mướn
employment t(n) sự thuê mướn
unemploymentt(n) sự thất nghiệp, nạn thất nghiệp
empty t(adj) (v) trống, rỗng; đổ, dốc; uống, làm cạn
enablet(v) làm cho có thể, có khả năng; cho phép ai làm gì
encountert(v) (n) chạm chán, bắt gặp; sự chạm trán, sự bắt gặp
encouraget(v) động viên, ủng hộ, giúp đỡ, làm can đảm, mạnh dạn
encouragement t(n) niềm cổ vũ, động viên, khuyến khích, sự làm can đảm
endt(n) (v) giới hạn, sự kết thúc; kết thúc, chấm dứt
in the end tcuối cùng, về sau
endingt(n) sự kết thúc, sự chấm dứt; phần cuối, kết cục
enemy t(n) kẻ thù, quân địch
energyt(n) năng lượng, nghị lực, sinh lực
engaget(v) hứa hẹn, cam kết, đính ước
engaged t(adj) đã đính ước, đã hứa hôn
enginet(n) máy, động cơ
engineer	t(n) kỹ sư
engineeringt(n) nghề kỹ sư, công việc của kỹ sư
enjoy t(v) thưởng thức, thích thú cái gì, được hưởng, có được
enjoyablet(adj) thú vị, thích thú
enjoymentt(n) sự thích thú, sự có được, được hưởng
enormous	t(adj) to lớn, khổng lồ
enoughtpro (n) (adv) đủ
enquiry t(n) sự điều tra, sự thẩm vấn
ensuret(v) bảo đảm, chắc chắn
enter t(v) đi vào, gia nhập
entertaint(v) giải trí, tiếp đón, chiêu đãi
entertainingt(adj) giải trí
entertainert(n) người quản trò, người tiếp đãi, chiêu đãi
entertainment t(n) sự giải trí, sự tiếp đãi, chiêu đãi
enthusiasm t(n) sự hăng hái, sự nhiệt tình
enthusiastict(adj) hăng hái, say mê, nhiệt tình
entiret(adj) toàn thể, toàn bộ
entirely	t(adv) toàn vẹn, trọn vẹn, toàn bộ
entitle t(v) cho tiêu đề, cho tên (sách); cho quyền làm gì
entrance	t(n) sự đi vào, sự nhậm chức
entry t(n) sự ghi vào sổ sách, sự đi vào, sự tiếp nhận (pháp lý)
envelope	t(n) phong bì
environmentt(n) môi trường, hoàn cảnh xung quanh
environmental t(adj) thuộc về môi trường
equal t(n) (v) ngang, bằng; người ngang hàng, ngang tài,sức
equally t(adv) bằng nhau, ngang bằng
equipmentt(n) trang, thiết bị
equivalent t(adj) (n) tương đương; từ, vật tương đương
error t(n) lỗi, sự sai sót, sai lầm
escapet(v) (n) trốn thoát, thoát khỏi; sự trốn thoát, lỗi thoát
especially t(adv) đặc biệt là, nhất là
essay t(n) bài tiểu luận
essentialt(adj) (n) bản chất, thực chất, cốt yếu; yếu tố cần thiết
essentiallyt(adv) về bản chất, về cơ bản
establisht(v) lập, thành lập
estatet(n) tài sản, di sản, bất động sản
estimate	t(n) (v) sự ước lượng, đánh giá; ước lượng, đánh giá
event(adv) (adj) ngay cả, ngay, lại còn; bằng phẳng, điềm đạm,ngang bằng
evening t(n) buổi chiều, tối
event t(n) sự việc, sự kiện
eventually t(adv) cuối cùng
evert(adv) từng, từ trước tới giờ
every t(det) mỗi, mọi
evidence	t(n) điều hiển nhiên, điều rõ ràng
evilt(adj) (n) xấu, ác; điều xấu, điều ác, điều tai hại
exact t(adj) chính xác, đúng
exactly t(adv) chính xác, đúng đắn
exaggerate t(v) cường điệu, phóng đại
exaggeratedt(adj) cường điệu, phòng đại
examt(n) viết tắt của Examination
examinationt(n) sự thi cử, kỳ thi
examine t(v) thẩm tra, khám xét, hỏi han (thí sinh)
example t(n) thí dụ, ví dụ
excellentt(adj) xuất sắc, xuất chúng
exceptt(prep) (conj) trừ ra, không kể; trừ phi
exceptiont(n) sự trừ ra, sự loại ra
exchange	t(v) (n) trao đổi; sự trao đổi
in exchange for ttrong việc trao đổi về
excitet(v) kích thích, kích động
exciting	t(adj) hứng thú, thú vị
excited t(adj) bị kích thích, bị kích động
excitement t(n) sự kích thích, sự kích động
exclude t(v) ngăn chạn, loại trừ
excludingt(prep) ngoài ra, trừ ra
excuset(n) (v) lời xin lỗi, bào chữa; xin lỗi, tha thứ, tha lỗi
executivet(n) (adj) sự thi hành, chấp hành; (thuộc) sự thi hành,chấp hành
exercise	t(n) (v) bài tập, sự thi hành, sự thực hiện; làm, thi hành, thực hiện
exhibit t(v) (n) trưng bày, triển lãm; vật trưng bày, vật triển lãm
exhibition t(n) cuộc triển lãm, trưng bày
exist t(v) tồn tại, sống
existencet(n) sự tồn tại, sự sống
exitt(n) lỗi ra, sự đi ra, thoát ra
expandt(v) mở rộng, phát triển, nở, giãn ra
expectt(v) chờ đợi, mong ngóng; liệu trước
expected	t(adj) được chờ đợi, được hy vọng
unexpected t(adj) bất ngờ, đột ngột, gây ngạc nhiên
unexpectedlyt(adv) bất ngờ, đột ngột, gây ngạc nhiên
expectationt(n) sự mong chờ, sự chờ đợi
expense t(n) chi phí
expensivet(adj) đắt
experience t(n) (v) kinh nghiệm; trải qua, nếm mùi
experiencedt(adj) có kinh nghiệm, từng trải, giàu kinh nghiệm
experiment t(n) (v) cuộc thí nghiệm, thí nghiệm
expertt(n) (adj) chuyên gia; chuyên môn, thành thạo
explain t(v) giải nghĩa, giải thích
explanationt(n) sự giải nghĩa, giải thích
explode t(v) đập tan (hy vọng...), làm nổ, nổ
explore t(v) thăm dò, thám hiểm
explosiont(n) sự nổ, sự phát triển ồ ạt
exportt(v) (n) xuất khẩu; hàng xuất khẩu, sự xuất khẩu
exposet(v) trưng bày, phơi bày
express t(v) (adj) diễn tả, biểu lộ, bày tỏ; nhanh, tốc hành
expression t(n) sự diễn tả, sự bày tỏ, biểu lộ, sự diễn đạt
extendt(v) giơ, duỗi ra (tay, chân); kéo dài (thời gian),dành cho, gửi lời
extensiont(n) sự giơ, duỗi; sự kéo dài, sự dành cho, gửi lời
extensivet(adj) rộng rãi, bao quát
extentt(n) (v) quy mô, phạm vi
extra t(adj) (n) (adv) thêm, phụ, ngoại; thứ thêm, phụ
extraordinary t(adj) đặc biệt, lạ thường, khác thường
extreme t(adj) (n) vô cùng, khắc nghiệt, quá khích, cực đoan; sự quá khích
extremelyt(adv) vô cùng, cực độ
facet(n) (v) mặt, thể diện; đương đầu, đối phó, đối mặt
facility	t(n) điều kiện dễ dàng, sự dễ dàng, thuận lợi
factt(n) việc, sự việc, sự kiện
factort(n) nhân tố
factory t(n) nhà máy, xí nghiệp, xưởng
failt(v) sai, thất bại
failure t(n) sự thất bại, người thất bại
faint t(adj) nhút nhát, yếu ớt
faintly t(adv) nhút nhát, yếu ớt
fairt(adj) hợp lý, công bằng; thuận lợi
fairlyt(adv) hợp lý, công bằng
unfairt(adj) gian lận, không công bằng; bất lợi
unfairly	t(adv) gian lận, không công bằng; bất lợi
faith t(n) sự tin tưởng, tin cậy; niềm tin, vật đảm bảo
faithful	t(adj) trung thành, chung thủy, trung thực
faithfully t(adv) trung thành, chung thủy, trung thực
yours faithfully	tbạn chân thành
fallt(v) (n) rơi, ngã, sự rơi, ngã
fall overtngã lộn nhào, bị đổ
false t(adj) sai, nhầm, giả dối
famet(n) tên tuổi, danh tiếng
familiar	t(adj) thân thiết, quen thuộc
familyt(n) (adj) gia đình, thuộc gia đình
famoust(adj) nổi tiếng
fancy t(v) (adj) tưởng tượng, cho, nghĩ rằng; tưởng tượng
fart(adv) (adj) xa
further t(adj) xa hơn nữa; thêm nữa
farmt(n) trang trại
farming t(n) công việc trồng trọt, đồng áng
farmert(n) nông dân, người chủ trại
fashion t(n) mốt, thời trang
fashionablet(adj) đúng mốt, hợp thời trang
fastt(adj) (adv) nhanh
fastent(v) buộc, trói
fatt(adj) (n) béo, béo bở; mỡ, chất béo
faucett(n) vòi (ở thùng rượu....)
fault t(n) sự thiết sót, sai sót
favourt(n) thiện ý, sự quý mến; sự đồng ý; sự chiếu cố
in favour oftủng hộ cái gì
favouritet(adj) (n) được ưa thích; người (vật) được ưa thích
feart(n) (v) sự sợ hãi, e sợ; sợ, lo ngại
feather t(n) lông chim
feature t(n) (v) nét đặt biệt, điểm đặc trưng; mô tả nét đặc biệt,đặc trưng của...
February	ttháng 2
federal t(adj) liên bang
feet(n) tiền thù lao, học phí
feedt(v) cho ăn, nuôi
feelt(v) cảm thấy
feeling t(n) sự cảm thấy, cảm giác
fellowt(n) anh chàng (đang yêu), đồng chí
femalet(adj) (n) thuộc giống cái; giống cái
fence t(n) hàng rào
festival	t(n) lễ hội, đại hội liên hoan
fetch t(v) tìm về, đem về; làm bực mình; làm say mê, quyến rũ
fever t(n) cơn sốt, bệnh sốt
fewt(adj) pro(n) ít,vài; một ít, một vài
a few tmột ít, một vài
field t(n) cánh đồng, bãi chiến trường
fight t(v) (n) đấu tranh, chiến đấu; sự đấu tranh, cuộc chiến đấu
fighting	t(n) sự chiến đấu, sự đấu tranh
figuret(n) (v) hình dáng, nhân vật; hình dung, miêu tả
filet(n) hồ sơ, tài liệu
fillt(v) làm đấy, lấp kín
filmt(n) (v) phim, được dựng thành phim
final t(adj) (n) cuối cùng, cuộc đấu chung kết
finally t(adv) cuối cùng, sau cùng
finance t(n) (v) tài chính; tài trợ, cấp vốn
financialt(adj) thuộc (tài chính)
findt(v) tìm, tìm thấy
find out sthtkhám phá, tìm ra
finet(adj) tốt, giỏi
finelyt(adv) đẹp đẽ, tế nhị, cao thượng
fingert(n) ngón tay
finisht(v) (n) kết thúc, hoàn thành; sự kết thúc, phần cuối
finished	t(adj) hoàn tất, hoàn thành
firet(n) (v) lửa; đốt cháy
set fire totđốt cháy cái gì
firmt(n) (adj) (adv) hãng, công ty; chắc, kiên quyết, vững vàng
firmlyt(adv) vững chắc, kiên quyết
first t(adv) (n) thứ nhất, đầu tiên, trước hết; người, vật đầu tiên, thứ nhất
at first	ttrực tiếp
fisht(n) (v) cá, món cá; câu cá, bắt cá
fishing t(n) sự câu cá, sự đánh cá
fitt(v) (adj) hợp, vừa; thích hợp, xứng đáng
fixt(v) đóng, gắn, lắp; sửa chữa, sửa sang
fixed t(adj) đứng yên, bất động
flagt(n) quốc kỳ
flame t(n) ngọn lửa
flash t(v) (n) loé sáng, vụt sáng; ánh sáng lóe lên, đèn nháy
flatt(adj) (n) bằng phẳng, bẹt, nhẵn; dãy phòng, căn phòng, mặt phẳng
flavour t(n) (v) vị, mùi; cho gia vị, làm tăng thêm mùi vị
flesh t(n) thịt
flightt(n) sự bỏ chạy, rút chạy; sự bay, chuyến bay
float t(v) nổi, trôi, lơ lửng
flood t(n) (v) lụt, lũ lụt; tràn đầy, tràn ngập
floor t(n) sàn, tầng (nhà)
flour t(n) bột, bột mỳ
flowt(n) (v) sự chảy; chảy
flut(n) bệnh cúm
flyt(v) (n) bay; sự bay, quãng đường bay
flyingt(adj) (n) biết bay; sự bay, chuyến bay
focus t(v) (n) tập trung; trung tâm, trọng tâm
foldt(v) (n) gấp, vén, xắn; nếp gấp
folding t(adj) gấp lại được
followt(v) đi theo sau, theo, tiếp theo
followingt(adj) (n)prep.tiếp theo, theo sau, sau đây; sau, tiếp theo
foott(n) chân, bàn chân
football	t(n) bóng đá
fort(prep) cho, dành cho...
force t(n) (v) sức mạnh; ép buộc, cưỡng ép
forecast	t(n) (v) sự dự đoán, dự báo; dự đoán, dự báo
foreign t(adj) (thuộc) nước ngoài, từ nước ngoài, ở nước ngoài
forestt(n) rừng
forever t(adv) mãi mãi
forgett(v) quên
forgive t(v) tha, tha thứ
forkt(n) cái nĩa
formt(n) (v) hình thể, hình dạng, hình thức; làm thành, được tạo thành
formalt(adj) trang trọng,theo nghi thức
formalizet(v) nghi thức hóa,trang trọng hóa
formert(adj) trước, cũ, xưa, nguyên
formerly	t(adv) trước đây, thuở xưa
formula t(n) công thức, thể thức, cách thức
fortune t(n) sự giàu có, sự thịnh vượng
forward t(adj) (adv) về tương lai, sau này ở phía trước,tiến về phía trước
foundation t(n) sự thành lập, sự sáng lập; tổ chức
frame t(n) (v) cấu trúc, hệ thống; dàn xếp, bố trí
freet(adj) (v) (adv) miễn phí, tự do, giải phóng, trả tự do
freelyt(adv) tự do, thoải mái
freedom t(n) sự tự do; nền tự do
freezet(v) đóng băng, đông lạnh
frozent(adj) lạnh giá
frequent	t(adj) thường xuyên
frequently t(adv) thường xuyên
fresh t(adj) tươi, tươi tắn
freshly t(adv) tươi mát, khỏe khoắn
fridget(n) tủ lạnh
make friends withtkết bạn với
friendly	t(adj) thân thiện, thân mật
unfriendly t(adj) không thân thiện, không có thiện cảm
friendship t(n) tình bạn, tình hữu nghị
frighten	t(v) làm sợ, làm hoảng sợ
frighteningt(adj) kinh khủng, khủng khiếp
frightened t(adj) hoảng sợ, khiếp sợ
front t(n) (adj) mặt; đằng trước, về phía trước
in front oftở phía trước
freezet(n) (v) sự đông lạnh, sự giá lạnh; làm đông, làm đóng băng
fruit t(n) quả, trái cây
fryt(v) (n) rán, chiên; thịt rán
fuelt(n) chất đốt, nhiên liệu
fullt(adj) đầy, đầy đủ
fully t(adv) đầy đủ, hoàn toàn
funt(n) (adj) sự vui đùa, sự vui thích; hài hước
make fun oftđùa cợt, chế giễu, chế nhạo
function	t(n) (v) chức năng; họat động, chạy (máy)
fundt(n) (v) kho, quỹ; tài trợ, tiền bạc, để tiền vào công quỹ
fundamentalt(adj) cơ bản, cơ sở, chủ yếu
funeral t(n) lễ tang, đám tang
funny t(adj) buồn cười, khôi hài
furt(n) bộ da lông thú
furnituret(n) đồ đạc (trong nhà)
further t(adj) xa hơn nữa, thêm nữa, bên kia
furthest	t(adj) (adv) xa hơn hết, xa nhất
futuret(n) (adj) tương lai
gaint(v) (n) lợi, lợi ích; giành được, kiếm được, đạt tới
gallont(n) Galông 1gl = 4, 54 lít ở Anh, 3, 78 lít ở Mỹ
gamblet(v) (n) đánh bạc; cuộc đánh bạc
gambling	t(n) trò cờ bạc
gapt(n) đèo, lỗ hổng, kẽ hở; chỗ trống
garaget(n) nhà để ô tô
garbage t(n) lòng, ruột (thú)
gardent(n) vườn
gast(n) khí, hơi đốt
gasoline	t(n) dầu lửa, dầu hỏa, xăng
gatet(n) cổng
gathert(v) tập hợp; hái, lượm, thu thập
geart(n) cơ cấu, thiết bị, dụng cụ
general t(adj) chung, chung chung; tổng
generallyt(adv) nói chung, đại thể
in general tnói chung, đại khái
generate	t(v) sinh, đẻ ra
generation t(n) sự sinh ra, sự phát sinh ra; thế hệ, đời
generous	t(adj) rộng lượng, khoan hồng, hào phóng
generously t(adv) rộng lượng, hào phóng
gentlet(adj) hiền lành, dịu dàng, nhẹ nhàng
gentlyt(adv) nhẹ nhàng, êm ái, dịu dàng
gentlemant(n) người quý phái, người thượng lưu
genuine t(adj) thành thật, chân thật; xác thực
genuinelyt(adv) thành thật, chân thật
geographyt(n) địa lý, khoa địa lý
gett(v) được, có được
get ontleo, trèo lên (xe buýt, xe lửa,..)
get off tra khỏi, thoát khỏi, xuống ( xe buýt,xe lửa,...)
giant t(n) (adj) người khổng lồ, người phi thường; khổng lồ, phi thường
giftt(n) quà tặng
givet(v) cho, biếu, tặng
give sth away tcho, phát
give sth outtchia, phân phối
give sth uptbỏ, từ bỏ
gladt(adj) vui lòng, sung sướng
glass t(n) kính, thủy tinh, cái cốc, ly
glasses t(n) kính đeo mắt
globalt(adj) v toàn cầu, toàn thể, toàn bộ
glove t(n) bao tay, găng tay
gluet(n) (v) keo, hồ; gắn lại, dán bằng keo, hồ
gramt(n) đậu xanh
go down tđi xuống
go up tđi lên
be going totsắp sửa, có ý định
goalt(n) khung thành, bàn thắng, đích, mục đích
goldt(n) (adj) vàng; bằng vàng
goodt(adj) (n) tốt, hay, tuyệt; điều tốt, điều thiện
good at ttiến bộ ở
good for	tcó lợi cho
goods t(n) của cải, tài sản, hàng hóa
governt(v) cai trị, thống trị, cầm quyền
government t(n) chính phủ, nội các; sự cai trị
governor	t(n) thủ lĩnh, chủ; kẻ thống trị
grabt(v) túm lấy, vồ, chộp lấy
grade t(n) (v) điểm, điểm số; phân loại, xếp loại
gradual t(adj) dần dần, từng bước một
graduallyt(adv) dần dần, từ từ
grain t(n) thóc lúa, hạt, hột; tính chất, bản chất
grammar t(n) ngữ pháp, văn phạm
grand t(adj) rộng lớn, vĩ đại
grandchild t(n) cháu (của ông bà)
granddaughter t(n) cháu gái
grant t(v) (n) cho, ban, cấp; sự cho, sự ban, sự cấp
grandson	t(n) cháu trai
grass t(n) cỏ; bãi cỏ, đồng cỏ
grateful	t(adj) biết ơn, dễ chịu, khoan khoái
grave t(n) (adj) mộ, dấu huyền; trang nghiêm, nghiêm trọng
grayt(adj) xám, hoa râm (tóc)
greyt(adj) xám, hoa râm (tóc),xám xịt
great t(adj) to, lớn, vĩ đại
greatly t(adv) rất, lắm; cao thượng, cao cả
grocery t(n) cửa hàng tạp phẩm
groundt(n) mặt đất, đất, bãi đất
group t(n) nhóm
growt(v) mọc, mọc lên
grow up tlớn lên, trưởng thành
growtht(n) sự lớn lên, sự phát triển
guaranteet(n) (v) sự bảo hành, bảo lãnh, người bảo lãnh; cam đoan, đảm bảo
guard t(n) (v) cái chắn, người bảo vệ; bảo vệ, gác, canh giữ
guess t(v) (n) đoán, phỏng đoán; sự đoán, sự ước chừng
guest t(n) khách, khách mời
guide t(n) (v) điều chỉ dẫn, người hướng dẫn; dẫn đường, chỉ đường
guiltyt(adj) có tội, phạm tội, tội lỗi
gunt(n) súng
guyt(n) bù nhìn, anh chàng, gã
habit t(n) thói quen, tập quán
hairdressert(n) thợ làm tóc
halftpro(n) (adv) một nửa, phần chia đôi, nửa giờ; nửa
hallt(n) đại sảnh, tòa (thị chính), hội trường
hammert(n) búa
handt(n) (v) tay, bàn tay; trao tay, truyền cho
handlet(v) (n) cầm, sờ mó; tay cầm, móc quai
hangt(v) treo, mắc
happent(v) xảy ra, xảy đến
happinesst(n) sự sung sướng, hạnh phúc
unhappinesst(n) nỗi buồn, sự bất hạnh
happily t(adv) sung sướng, hạnh phúc
unhappy t(adj) buồn rầu, khốn khổ
hardt(adj) (adv) cứng, rắn, hà khắc; hết sức cố gắng, tích cực
hardlyt(adv) khắc nghiệt, nghiêm khắc, tàn tệ, khó khăn
harmt(n) (v) thiệt hại, tổn hao; làm hại, gây thiệt hại
harmful t(adj) gây tai hại, có hại
harmless	t(adj) không có hại
hatet(v) (n) ghét; lòng căm ghét, thù hận
hatredt(n) lòng căm thì, sự căm ghét
headt(n) (v) cái đầu (người, thú); chỉ huy, lãnh đại, dẫn đầu
headache	t(n) chứng nhức đầu
healt(v) chữa khỏi, làm lành
healtht(n) sức khỏe, thể chất, sự lành mạnh
healthy t(adj) khỏe mạnh, lành mạnh
heart(v) nghe
hearing t(n) sự nghe, thính giác
heart t(n) tim, trái tim
heatt(n) (v) hơi nóng, sức nóng
heating t(n) sự đốt nóng, sự làm nóng
heavent(n) thiên đường
heavy t(adj) nặng, nặng nề
heavily t(adv) nặng, nặng nề
heelt(n) gót chân
heightt(n) chiều cao, độ cao; đỉnh, điểm cao
helpful t(adj) có ích; giúp đỡ
hence t(adv) sau đây, kể từ đây; do đó, vì thế
hesitate	t(v) ngập ngừng, do dự
hidet(v) trốn, ẩn nấp; che giấu
hight(adj) (adv) cao, ở mức độ cao
highlyt(adv) tốt, cao; hết sức, ở mức độ cao
highlightt(v) (n) làm nổi bật, nêu bật; chỗ nổi bật nhất, đẹp, sáng nhất
highway t(n) đường quốc lộ
hillt(n) đồi
hipt(n) hông
hiret(v) (n) thuê, cho thuê (nhà...); sự thuê, sự cho thuê
history t(n) lịch sử, sử học
historical t(adj) lịch sử, thuộc lịch sử
hitt(v) (n) đánh, đấm, ném trúng; đòn, cú đấm
hobby t(n) sở thích riêng
holdt(v) (n) cầm, nắm, giữ; sự cầm, sự nắm giữ
holet(n) lỗ, lỗ trống; hang
hollowt(adj) rỗng, trống rỗng
holyt(adj) linh thiêng; sùng đạo
honestt(adj) lương thiện, trung thực, chân thật
honestly	t(adj) lương thiện, trung thực, chân thật
honourt(n) danh dự, thanh danh, lòng kính trọng
in honour oftđể tỏ lòng tôn kính, trân trọng đối với
hookt(n) cái móc; bản lề; lưỡi câu
horizontal t(adj) (thuộc) chân trời, ở chân trời; ngang, nằm ngang (trục hoành)
hornt(n) sừng (trâu, bò...)
horrort(n) điều kinh khủng, sự ghê rợn
horse t(n) ngựa
hospital	t(n) bệnh viện, nhà thương
hostt(n) (v) chủ nhà, chủ tiệc; dẫn (c.trình), đăng cai tổ chức (hội nghị)
housing t(n) nơi ăn chốn ở
householdt(n) (adj) hộ, gia đình; (thuộc) gia đình
huget(adj) to lớn, khổng lồ
human t(adj) (n) (thuộc) con người, loài người
humorous	t(adj) hài hước, hóm hỉnh
humourt(n) sự hài hước, sự hóm hỉnh
hungryt(adj) đói
huntt(v) săn, đi săn
hunting t(n) sự đi săn
hurry t(v) (n) sự vội vàng, sự gấp rút
in a hurry tvội vàng, hối hả, gấp rút
'hʌri t(v) làm bị thương, gây thiệt hại
husband t(n) người chồng
icet(n) băng, nước đá
ideat(n) ý tưởng, quan niệm
ideal t(adj) (n) (thuộc) quan niệm, tư tưởng; lý tưởng
ideally t(adv) lý tưởng, đúng như lý tưởng
identify	t(v) nhận biết, nhận ra, nhận dạng
identity	t(n) cá tính, nét nhận dạng; tính đồng nhất, giống hệt
ignoret(v) phớt lờ, tỏ ra không biết đến
illt(adj) ốm
illegal t(adj) trái luật, bất hợp pháp
illegallyt(adv) trái luật, bất hợp pháp
illness t(n) sự đau yếu, ốm, bệnh tật
illustrate t(v) minh họa, làm rõ ý
image t(n) ảnh, hình ảnh
imaginaryt(adj) tưởng tượng, ảo
imaginationt(n) trí tưởng tượng, sự tưởng tượng
imagine t(v) tưởng tượng, hình dung; tưởng rằng, cho rằng
immediatet(adj) lập tức, tức thì
immediatelyt(adv) ngay lập tức
immoral t(adj) trái đạo đức, luân lý; xấu xa
impactt(n) sự và chạm, sự tác động, ảnh hưởng
impatientt(adj) thiếu kiên nhẫn, nóng vội
impatientlyt(adv) nóng lòng, sốt ruột
implicationt(n) sự lôi kéo, sự liên can, điều gợi ý
imply t(v) ngụ ý, bao hàm
importt(n) (v) sự nhập, sự nhập khẩu; nhập, nhập khẩu
importance t(n) sự quan trọng, tầm quan trọng
importantt(adj) quan trọng, hệ trọng
importantlyt(adv) quan trọng, trọng yếu
unimportantt(adj) không quan trọng, không trọng đại
imposet(v) đánh (thuế...), bắt gánh vác; đánh tráo, lợi dụng
impossible t(adj) không thể làm được, không thể xảy ra
impress t(v) ghi, khắc, in sâu vào; gây ấn tượng, làm cảm động
impressedt(adj) được ghi, khắc, in sâu vào
impression t(n) ấn tượng, cảm giác; sự in, đóng dấu
impressive t(adj) gây ấn tượng mạnh; hùng vĩ, oai vệ
improve t(v) cải thiện, cái tiến, mở mang
improvementt(n) sự cái thiện, sự cải tiến, sự mở mang
inabilityt(n) sự bất lực, bất tài
incident	t(n) việc xảy ra, việc có liên quan
include t(v) bao gồm, tính cả
includingt(prep) bao gồm, kể cả
incomet(n) lợi tức, thu nhập
increase	t(v) (n) tăng, tăng thêm; sự tăng, sự tăng thêm
increasinglyt(adv) tăng thêm
indeedt(adv) thật vậy, quả thật
independencet(n) sự độc lập, nền độc lập
independentt(adj) độc lập
independently t(adv)độc lập
index t(n) chỉ số, sự biểu thị
indicate	t(v) chỉ, cho biết; biểu thị, trình bày ngắn gọn
indication t(n) sự chỉ, sự biểu thị, sự biểu lộ
indirect	t(adj) gián tiếp
indirectly t(adv) gián tiếp
individual t(adj) (n) riêng, riêng biệt; cá nhân
indoors t(adv) ở trong nhà
indoort(adj) trong nhà
industrial t(adj) (thuộc) công nghiệp, kỹ nghệ
industry	t(n) công nghiệp, kỹ nghệ
inevitable t(adj) không thể tránh được, chắc chắn xảy ra; vẫn thường thấy,nghe
inevitably t(adv) chắc chắn
infectt(v) nhiễm, tiêm nhiễm, đầu độc, lan truyền
infected	t(adj) bị nhiễm, bị đầu độc
infectiont(n) sự nhiễm, sự đầu độc
infectious t(adj) lây, nhiễm
influencet(n) (v) sự ảnh hưởng, sự tác dụng; ảnh hưởng, tác động
informt(v) báo cho biết, cung cấp tin tức
informal	t(adj) không chính thức, không nghi thức
informationt(n) tin tức, tài liệu, kiến thức
ingredient t(n) phần hợp thành, thành phần
initial t(adj) (n) ban đầu, lúc đầu; chữ đầu (của 1 tên gọi)
initiallyt(adv) vào lúc ban đầu, ban đ
initiative t(n) bước đầu, sự khởi đầu
injuret(v) làm tổn thương, làm hại, xúc phạm
injured t(adj) bị tổn thương, bị xúc phạm
injuryt(n) sự làm tổn thương, làm hại; điều hại, điều tổn hại
inkt(n) mực
inner t(adj) ở trong, nội bộ; thân cận
innocent	t(adj) vô tội, trong trắng, ngây thơ
insectt(n) sâu bọ, côn trùng
insertt(v) chèn vào, lồng vào
insidet(n) (adj) mặt trong, phía, phần trong; ở trong, nội bộ
insist ont(v) cứ nhất định, cứ khăng khăng
install t(v) đặt (hệ thống máy móc, thiết bị...)
instance	t(n) thí dị, ví dụ; trường hợp cá biệt
for instancetví dụ chẳng hạn
instead t(adv) để thay thế
instead of tthay cho
institutet(n) viện, học viện
institutiont(n) sự thành lập, lập; cơ quan, trụ sở
instructiont(n) sự dạy, tài liệu cung cấp
instrument t(n) dụng cụ âm nhạc khí
insultt(v) (n) lăng mạ, xỉ nhục; lời lăng mạ, sự xỉ nhục
insultingt(adj) lăng mạ, xỉ nhục
insurancet(n) sự bảo hiểm
intelligencet(n) sự hiểu biết, trí thông minh
intelligentt(adj) thông minh, sáng trí
intendt(v) ý định, có ý định
intended	t(adj) có ý định, có dụng ý
intentiont(n) ý định, mục đích
interest	t(n) (v) sự thích thú, sự quan tâm, chú ý; làm quan tâm, chú ý
interestingt(adj) làm thích thú, làm quan tâm, làm chú ý
interested t(adj) có thích thú, có quan tâm, có chú ý
interior	t(n) (adj) phần trong, phía trong; ở trong, ở phía trong
internal	t(adj) ở trong, bên trong, nội địa
international t(adj) quốc tế
interprett(v) giải thích
interpretationt(n) sự giải thích
interruptt(v) làm gián đoạn, ngắt lời
interruptiont(n) sự gián đoạn, sự ngắt lời
interval	t(n) khoảng (k-t.gian), khoảng cách
interviewt(n) (v) cuộc phỏng vấn, sự gặp mặt; phỏng vấn, nói chuyện riêng
intot(prep) vào, vào trong
introducet(v) giới thiệu
introductiont(n) sự giới thiệu, lời giới thiệu
inventt(v) phát minh, sáng chế
inventiont(n) sự phát minh, sự sáng chế
investt(v) đầu tư
investigatet(v) điều tra, nghiên cứu
investigation t(n) sự điều tra, nghiên cứu
investment t(n) sự đầu tư, vốn đầu tư
invitation t(n) lời mời, sự mời
invitet(v) mời
involve t(v) bao gồm, bao hàm; thu hút, dồn tâm trí
involved intđể hết tâm trí vào
involvementt(n) sự gồm, sự bao hàm; sự để, dồn hết tâm trí vào
iront(n) (v) sắt; bọc sắt
irritate	t(v) làm phát cáu, chọc tức
irritating t(adj) làm phát cáu, chọc tức
irritatedt(adj) tức giận, cáu tiết
islandt(n) /´ailənd/ hòn đảo
issue t(n) (v) sự phát ra, sự phát sinh; phát hành, đưa ra
itemt(n) tin tức; khoả(n)., mó(n).., tiết mục
jackett(n) áo vét
jamt(n) mứt
jealous t(adj) ghen, ghen tị
jelly t(n) thạch
jewellerytn) nữ trang, kim hoàn
joint(v) gia nhập, tham gia; nối, chắp, ghép
joint t(adj) (n) chung (giữa 2 người hoặc hơn); chỗ nối, đầu nối
jointly t(adv) cùng nhau, cùng chung
joket(n) (v) trò cười, lời nói đùa; nói đùa, giễu cợt
journalist t(n) nhà báo
journey t(n) cuộc hành trình (đường bộ); quãng đường, chặng đường đi
joyt(n) niềm vui, sự vui mừng
judge t(n) (v) xét xử, phân xử; quan tòa, thẩm phán
judgementt(n)
juice t(n) nước ép (rau, củ, quả)
jumpt(v) (n) nhảy; sự nhảy, bước nhảy
juniort(adj) (n) trẻ hơn, ít tuổi hơn; người ít tuổi hơn
justt(adv) đúng, vừa đủ; vừa mới, chỉ
justice t(n) sự công bằng
justify t(v) bào chữa, biện hộ
justifiedt(adj) hợp lý, được chứng minh là đúng
keent(adj) sắc, bén
keen on tsay mê, ưa thích
keept(v) giữ, giữ lại
keyboard	t(n) bàn phím
kickt(v) (n) đá; cú đá
kidt(n) con dê non,đứa trẻ con
killing t(n) sự giết chóc, sự tàn sát
kilometretKilômet
kindt(n) (adj) loại, giống; tử tế, có lòng tốt
kindlyt(adv) tử tế, tốt bụng
unkindt(adj) không tốt, độc ác, tàn nhẫn
kindness	t(n) sự tử tế, lòng tốt
kingt(n) vua, quốc vương
kneet(n) đầu gối
knife t(n) con dao
knitt(v) đan, thêu
knitted t(adj) được đan, được thêu
knitting	t(n) việc đan; hàng dệt kim
knock t(v) (n) đánh, đập; cú đánh
knott(n) cái nơ; điểm nút, điểm trung tâm
unknown t(adj) không biết, không được nhận ra
well known t(adj) nổi tiếng, được nhiều người biết đến
knowledget(n) sự hiểu biết, tri thức
litre t(n) lít
label t(n) (v) nhãn, mác; dán nhãn, ghi mác
laboratory t(n) phòng thí nghiệm
labourt(n) lao động; công việc
lackt(n) (v) sự thiếu; thiếu
lacking t(adj) ngu đần, ngây ngô
ladyt(n) người yêu, vợ, quý bà, tiểu thư
laket(n) hồ
lampt(n) đèn
landt(n) (v) đất, đất canh tác, đất đai
landscapet(n) phong cảnh
lanet(n) đường nhỏ (làng, hẻm phố)
language	t(n) ngôn ngữ
large t(adj) rộng, lớn, to
largely t(adv) phong phú, ở mức độ lớn
lastt(adv) (n) (v) lầm cuối, sau cùng; người cuối cùng
latet(adj) (adv) trễ, muộn
later t(adv) (adj) chậm hơn
latestt(adj) (n) muộn nhất, chậm nhất, gần đây nhất
lattert(adj) (n) sau cùng, gần đây, mới đây
laugh t(v) (n) cười; tiếng cười
launcht(v) (n) hạ thủy (tàu); khai trương; sự hạ thủy, buổi giới thiệu sản phẩm
lawt(n) luật
lawyert(n) luật sư
layt(v) xếp, đặt, bố trí
layer t(n) lớp
lazyt(adj) lười biếng
leadt(v) (n) lãnh đạo, dẫn dắt; sự lãnh đạo, sự hướng dẫn
leading t(adj) lãnh đạo, dẫn đầu
leadert(n) người lãnh đạo, lãnh tụ
leaft(n) lá cây, lá (vàng...)
leaguet(n) liên minh, liên hoàn
leant(v) nghiêng, dựa, ỷ vào
learn t(v) học, nghiên cứu
least tpro (n) (adv) tối thiểu; ít nhất
at least	tít ra, ít nhất, chí ít
leather t(n) da thuộc
leather t(v) bỏ đi, rời đi, để lại
leave outtbỏ quên, bỏ sót
lecture t(n) bài diễn thuyết, bài thuyết trình, bài nói chuyện
leftt(adv) (n) bên trái; về phía trái
legt(n) chân (người, thú, bàn..)
legal t(adj) hợp pháp
legally t(adv) hợp pháp
lendt(v) cho vay, cho mượn
lengtht(n) chiều dài, độ dài
lesstpro (n) (adv) nhỏ bé, ít hơn; số lượng ít hơn
lessont(n) bài học
lett(v) cho phép, để cho
lettert(n) thư; chữ cái, mẫu tự
level t(n) (adj) trình độ, cấp, vị trí; bằng, ngang bằng
library t(n) thư viện
licence tn) bằng, chứng chỉ, bằng cử nhân;sự cho phép
license t(v) cấp chứng chỉ, cấp bằng, cho phép
lidt(n) nắp, vung (xoong, nồi..); mi mắt (eyelid)
liet(v) (n) nói dối; lời nói dối, sự dối trá
lifet(n) đời, sự sống
liftt(v) (n) giơ lên, nhấc lên; sự nâng, sự nhấc lên
light t(n) (adj) (v) ánh sáng; nhẹ, nhẹ nhàng; đốt, thắp sáng
lightly t(adv) nhẹ nhàng
unliket(prep) (adj) khác, không giống
likelyt(adj) (adv) có thể đúng, có thể xảy ra, có khả năng; có thể,chắc vậy
unlikely	t(adj) không thể xảy ra, không chắc xảy ra
limit t(n) (v) giới hạn, ranh giới; giới hạn, hạn chế
limited t(adj) hạn chế, có giới hạn
linet(n) dây, đường, tuyến
linkt(n) (v) mắt xích, mối liên lạc; liên kết, kết nối
lipt(n) môi
liquidt(n) (adj) chất lỏng; lỏng, êm ái, du dương, không vững
listt(n) (v) danh sách; ghi vào danh sách
literature t(n) /ˈlɪtərətʃər/ văn chương, văn học
littletpro (n) (adv) nhỏ, bé, chút ít; không nhiều; một chút
a little	tnhỏ, một ít
livet(v) (adj) (adv) sống, hoạt động
livingt(adj) sống, đang sống
livelyt(adj) sống, sinh động
loadt(n) (v) gánh nặng, vật nặng; chất, chở
unloadt(v) cất gánh nặng, dỡ hàng
loant(n) sự vay mượn
local t(adj) địa phương, bộ phận, cục bộ
locally t(adv) có tính chất địa phương, cục bộ
locatet(v) xác định vị trí, định vị
located t(adj) định vị
location	t(n) vị trí, sự định vị
lockt(v) (n) mớ tóc, mớ bông; khóa
logic t(n) lô gic
logical t(adj) hợp lý, hợp logic
lonelyt(adj) cô đơn, bơ vơ
longt(adj) (adv) dài, xa; lâu
lookt(v) (n) nhìn; cái nhìn
look after ttrông nom, chăm sóc
look at tnhìn, ngắm, xem
look for	ttìm kiếm
look forward to tmong đợi cách hân hoan
loose t(adj) lỏng, không chặt
loosely t(adv) lỏng lẻo
lordt(n) Chúa, vua
lorry txe tải
loset(v) mất, thua, lạc
lostt(adj) thua, mất
losst(n) sự mất, sự thua
loudt(adj) (adv) to, inh ỏi, ầm ĩ; to, lớn (nói)
loudlyt(adv) ầm ĩ, inh ỏi
lowt(adj) (adv) thấp, bé, lùn
loyal t(adj) trung thành, trung kiên
luckt(n) may mắn, vận may
lucky t(adj) gặp may, gặp may mắn, hạnh phúc
unlucky t(adj) không gặp may, bất hạnh
luggage t(n) hành lý
lumpt(n) cục, tảng, miếng; cái bướu
lungt(n) phổi
machine t(n) máy, máy móc
machineryt(n) máy móc, thiết bị
madt(adj) điên, mất trí; bực điên người
magazine	t(n) tạp chí
magic t(n) (adj) ma thuật, ảo thuật; (thuộc) ma thuật, ảo thuật
mailt(n) (v) thư từ, bưu kiện; gửi qua bưu điện
maint(adj) chính, chủ yếu, trọng yếu nhất
mainlyt(adv) chính, chủ yếu, phần lớn
maintain	t(v) giữ gìn, duy trì, bảo vệ
major t(adj) lớn, nhiều hơn, trọng đại, chủ yếu
majority	t(n) phần lớn, đa số, ưu thế
maket(v) (n) làm, chế tạo; sự chế tạo
make sth uptlàm thành, cấu thành, gộp thành
make up t(n) đồ hóa trang, son phấn
malltbúa
managet(v) quản lý, trông nom, điều khiển
management t(n) sự quản lý, sự trông nom, sự điều khiển
manager t(n) người quản lý, giám đốc
mannert(n) /'mænз/ cách, lối, kiểu; dáng, vẻ, thái độ
manufacturet(v) (n) sự chế tạo, sự sản xuất, chế tạo, sản xuất
manufacturing t(n) sự sản xuất, sự chế tạo
manufacturert(n) người chế tạo, người sản xuất
mapt(n) bản đồ
March ttháng ba
march t(v) (n) diễu hành, hành quân; cuộc hành quân, cuộc diễu hành
markt(n) (v) dấu, nhãn, nhãn mác; đánh dấu, ghi dấu
markett(n) chợ, thị trường
marriage	t(n) sự cưới xin, sự kết hôn, lễ cưới
marry t(v) cưới (vợ), lấy (chồng)
married t(adj) cưới, kết hôn
masst(n) (adj) khối, khối lượng; quần chúng, đại chúng
massive t(adj) to lớn, đồ sộ
mastert(n) chủ, chủ nhân, thầy giáo, thạc sĩ
match t(n) (v) trận thi đấu, đối thủ, địch thủ; đối chọi, sánh được
matching	t(adj) tính địch thù, thi đấu
matet(n) (v) bạn, bạn nghề; giao phối
material	t(n) (adj) nguyên vật liệu; vật chất, hữu hình
mathematicst(n) toán học,môn toán
mattert(n) (v) chất, vật chất; có ý nghĩa, có tính chất quan trọng
maximum t(adj) (n) cực độ, tối đa; trị số cực đại, lượng cực đại, cực độ
maybe t(adv) có thể, có lẽ
mayor t(n) thị trưởng
mealt(n) bữa ăn
meant(v) nghĩa, có nghĩa là
meaning t(n) ý, ý nghĩa
means t(n) của cải, tài sản, phương tiện
by means oftbằng phương tiện
meanwhilet(adv) trong lúc đó, trong lúc ấy
measure t(v) (n) đo, đo lường; sự đo lường, đơn vị đo lường
measurementt(n) sự đo lường, phép đo
meatt(n) thịt
media t(n) phương tiện truyền thông đại chúng
medical t(adj) (thuộc) y học
medicine	t(n) y học, y khoa; thuốc
mediumt(adj) (n) trung bình, trung, vừa; sự trung gian, sự môi giới
meett(v) gặp, gặp gỡ
meeting t(n) cuộc mít tinh, cuộc biểu tình
meltt(v) tan ra, chảy ra; làm tan chảy ra
membert(n) thành viên, hội viên
membership t(n) tư cách hội viên, địa vị hội viên
memoryt(n) bộ nhớ, trí nhớ, kỉ niệm
in memory oftsự tưởng nhớ
mentalt(adj) (thuộc) trí tuệ, trí óc; mất trí
mentally	t(adv) về mặt tinh thần
mention t(v) kể ra, nói đến, đề cập
menut(n) thực đơn
meret(adj) chỉ là
merelyt(adv) chỉ, đơn thuần
messt(n) tình trạng bừa bộn, tình trạng lộn xộn; người nhếch nhác, bẩn thỉu
message t(n) tin nhắn, thư tín, điện thông báo, thông điệp
metal t(n) kim loại
methodt(n) phương pháp, cách thức
metre t(n) mét
middayt(n) trưa, buổi trưa
middlet(n) (adj) giữa, ở giữa
midnight	t(n) nửa đêm, 12h đêm
mildt(adj) nhẹ, êm dịu, ôn hòa
milet(n) dặm (đo lường)
military	t(adj) (thuộc) quân đội, quân sự
milligramtmi-li-gam
millimetre tmi-li-met
mindt(n) (v) tâm trí, tinh thần, trí tuệ; chú ý, để ý, chăm sóc, quan tâm
mineral t(n) (adj) công nhân, thợ mỏ; khoáng
minimum t(adj) (n) tối thiểu; số lượng tối thiểu, mức tối thiểu
minister	t(n) bộ trưởng
ministry	t(n) bộ
minor t(adj) nhỏ hơn, thứ yếu, không quan trọng
minority	t(n) phần ít, thiểu số
minutet(n) phút
mirrort(n) gương
misst(v) (n) lỡ, trượt; sự trượt, sự thiếu vắng
missing t(adj) vắng, thiếu, thất lạc
mistake t(n) (v) lỗi, sai lầm, lỗi lầm; phạm lỗi, phạm sai lầm
mistaken	t(adj) sai lầm, hiểu lầm
mixt(v) (n) pha, trộn lẫn; sự pha trộn
mixed t(adj) lẫn lộn, pha trộn
mixture t(n) sự pha trộn, sự hỗn hợp
mobilet(adj) chuyển động, di động
model t(n) mẫu, kiểu mẫu
modernt(adj) hiện đại, tân tiến
momentt(n) chốc, lát
monitor t(n) (v) lớp trưởng, màn hình máy tính; nghe, ghi phát thanh, giám sát
moodt(n) lối, thức, điệu
moont(n) mặt trăng
moral t(adj) (thuộc) đạo đức, luân lý, phẩm hạnh; có đạo đức
morally t(adv) có đạo đức
moreover	t(adv) hơn nữa, ngoài ra, vả lại
mosttpro (n) (adv) lớn nhất, nhiều nhất; nhất, hơn cả
mostlyt(adv) hầu hết, chủ yếu là
motiont(n) sự chuyển động, sự di động
motor t(n) động cơ mô tô
motorcycle t(n) xe mô tô
mount t(v) (n) leo, trèo; núi
mountain	t(n) núi
mouse t(n) chuột
mouth t(n) miệng
movet(v) (n) di chuyển, chuyển động; sự di chuyển, sự chuyển động
movingt(adj) động, hoạt động
movement	t(n) sự chuyển động, sự hoạt động; cử động, động tác
movie theater trạp chiếu phim
mudt(n) bùn
multiply	t(v) nhân lên, làm tăng lên nhiều lần; sinh sôi nảy nở
murdert(n) (v) tội giết người, tội ám sát; giết người, ám sát
musclet(n) cơ, bắp thịt
museumt(n) bảo tàng
music t(n) nhạc, âm nhạc
musical t(adj) (thuộc) nhạc, âm nhạc; du dương, êm ái
musician	t(n) nhạc sĩ
mystery t(n) điều huyền bí, điều thần bí
mysterious t(adj) thần bí, huyền bí, khó hiểu
nailt(n) móng (tay, chân) móng vuốt
naked t(adj) trần, khỏa thân, trơ trụi
narrowt(adj) hẹp, chật hẹp
nationt(n) dân tộc, quốc gia
national	t(adj) (thuộc) quốc gia, dân tộc
natural t(adj) (thuộc) tự nhiên, thiên nhiên
naturallyt(adv) vốn, tự nhiên, đương nhiên
naturet(n) tự nhiên, thiên nhiên
navyt(n) hải quân
nearbyt(adj) (adv) gần
nearlyt(adv) gần, sắp, suýt
neatt(adj) sạch, ngăn nắp; rành mạch
neatlyt(adv) gọn gàng, ngăn nắp
necessaryt(adj) cần, cần thiết, thiết yếu
necessarilyt(adv) tất yếu, nhất thiết
unnecessaryt(adj) không cần thiết, không mong muốn
neckt(n) cổ
needt(v) (n) cần, đòi hỏi; sự cần
needlet(n) cái kim, mũi nhọn
negative	t(adj) phủ định
neighbourt(n) hàng xóm
neighbourhood t(n) hàng xóm, vùng lân cận, khoảng, chừng
neither tpro (n) (adv) không này mà cũng không kia
nephewt(n) cháu trai
nerve t(n) khí lực, thần kinh, can đảm
nervous t(adj) hoảng sợ, dễ bị kích thích, hay lo lắng
nervouslyt(adv) bồn chồn, lo lắng
nestt(n) (v) tổ, ổ; làm tổ
nett(n) lưới, mạng
network t(n) mạng lưới, hệ thống
neverthelesst(adv) tuy nhiên, tuy thế mà
newly t(adv) mới
newst(n) tin, tin tức
newspapert(n) báo
nicet(adj) đẹp, thú vị, dễ chịu
nicelyt(adv) thú vị, dễ chịu
niece t(n) cháu gái
noise t(n) tiếng ồn, sự huyên náo
noisy t(adj) ồn ào, huyên náo
noisily t(adv) ồn ào, huyên náo
nonetpro(n) không ai, không người, vật gì
nonsense	t(n) lời nói vô lý, vô nghĩa
nort(conj) (adv) cũng không
normalt(adj) (n) thường, bình thường; tình trạng bình thường
normally	t(adv) thông thường, như thường lệ
north t(n) (adj) (adv) phía bắc, phương bắc
northern	t(adj) Bắc
noset(n) mũi
notet(n) (v) lời ghi, lời ghi chép; ghi chú, ghi chép
noticet(n) (v) thông báo, yết thị; chú ý, để ý, nhận biết
take notice oftchú ý
noticeable t(adj) đáng chú ý, đáng để ý
novel t(n) tiểu thuyết, truyện
nowhere t(adv) không nơi nào, không ở đâu
nuclear t(adj) (thuộc) hạt nhân
nurse t(n) y tá
nutt(n) quả hạch; đầu
obeyt(v) vâng lời, tuân theo, tuân lệnh
objectt(n) vật, vật thể; phản đối, chống lại
objectivet(n) (adj) mục tiêu, mục đích; (thuộc) mục tiêu,khách quan
observationt(n) sự quan sát, sự theo dõi
observe t(v) quan sát, theo dõi
obtaint(v) đạt được, giành được
obvious t(adj) rõ ràng, rành mạch, hiển nhiên
obviouslyt(adv) một cách rõ ràng, có thể thấy được
occasion	t(n) dịp, cơ hội
occasionallyt(adv) thỉnh thoảng, đôi khi
occupyt(v) giữ, chiếm lĩnh, chiếm giữ
occupied	t(adj) đang sử dụng, đầy (người)
occur t(v) xảy ra, xảy đến, xuất hiện
ocean t(n) đại dương
oddt(adj) kỳ quặc, kỳ cục, lẻ (số)
oddly t(adv) kỳ quặc, kỳ cục, lẻ (số)
offt(adv) (prep) tắt; khỏi, cách, rời
offence t(n) sự vi phạm, sự phạm tội
offendt(v) xúc phạm, làm bực mình, làm khó chịu
offensivet(adj) sự tấn công, cuộc tấn công
offer t(v) (n) biếu, tặng, cho; sự trả giá
officet(n) cơ quan, văn phòng, bộ
officer t(n) viên chức, cảnh sát, sĩ quan
official	t(adj) (n) (thuộc) chính quyền, văn phòng; viên chức, công chức
officially t(adv) một cách trịnh trọng, một cách chính thứ
old fashioned t(adj) lỗi thời
oncet(adv) (conj) một lần; khi mà, ngay khi, một khi
each other tnhau, lẫn nhau
onion t(n) củ hành
onlyt(adj) (adv) chỉ có 1, duy nhất; chỉ, mới
ontot(prep) về phía trên, lên trên
opent(adj) (v) mở, ngỏ; mở, bắt đầu, khai mạc
openlyt(adv) công khai, thẳng thắn
opening t(n) khe hở, lỗ; sự bắt đầu, sự khai mạc, lễ khánh thành
operate t(v) hoạt động, điều khiển
operationt(n) sự hoạt động, quá trình hoạt động
opinion t(n) ý kiến, quan điểm
opponent	t(n) địch thủ, đối thủ, kẻ thù
opportunityt(n) cơ hội, thời cơ
opposet(v) đối kháng, đối chọi, đối lập; chống đối, phản đối
opposing	t(adj) tính đối kháng, đối chọi
opposed to tchống lại, phản đối
opposite	t(adj) (adv) (n)prep.đối nhau, ngược nhau; trước mặt, đối diện; điều trái ngược
opposition t(n) sự đối lập, sự đối nhau; sự chống lại, sự phản đối;phe đối lập
optiont(n) sự lựa chọn
oranget(n) (adj) quả cam; có màu da cam
order t(n) (v) thứ, bậc; ra lệnh
in order tothợp lệ
ordinary	t(adj) thường, thông thường
organ t(n) đàn óoc gan
organizationt(n) tổ chức, cơ quan; sự tổ chức
organize	t(v) tổ chức, thiết lập
organizedt(adj) có trật tự, ngăn nắp, được sắp xếp, được tổ chức
origint(n) gốc, nguồn gốc, căn nguyên
original	t(adj) (n) (thuộc) gốc, nguồn gốc, căn nguyên; nguyên bản
originally t(adv) một cách sáng tạo, mới mẻ, độc đáo; khởi đầu, đầu tiên
other t(adj) pro(n) khác
otherwiset(adv) khác, cách khác; nếu không thì...; mặt khác
ought to	t(v) phải, nên, hẳn là
ourselvestpro(n) bản thân chúng ta, bản thân chúng tôi
outdoors	t(adv) ở ngoài trời, ở ngoài nhà
outdoor t(adj) ngoài trời, ở ngoài
outer t(adj) ở phía ngoài, ở xa hơn
outline t(v) (n) vẽ, phác tảo; đường nét, hình dáng, nét ngoài
outputt(n) sự sản xuất; sản phẩm, sản lượng
outside t(adj) (adv) bề ngoài, bên ngoài; ở ngoài
outstandingt(adj) nổi bật, đáng chú ý; còn tồn lại
ovent(n) lò (nướng)
overt(adv).prep. bên trên, vượt qua; lên, lên trên
overall t(adj) (adv) toàn bộ, toàn thể; tất cả, bao gồm
overcome	t(v) thắng, chiến thắng, khắc phục, đánh bại
owet(v) nợ, hàm ơn; có được (cái gì)
ownt(adj) pro (n) (v) của chính mình, tự mình; nhận, nhìn nhận
owner t(n) người chủ, chủ nhân
pacet(n) bước chân, bước
packt(v) (n) gói, bọc; bó, gói
package t(n) (v) gói đồ, bưu kiện; đóng gói, đóng kiện
packagingt(n) bao bì
packett(n) gói nhỏ
paget(n) trang (sách)
paint(n) sự đau đớn, sự đau khổ
painful t(adj) đau đớn, đau khổ
paint t(n) (v) sơn, vôi màu; sơn, quét sơn
painting	t(n) sự sơn; bức họa, bức tranh
painter t(n) họa sĩ
pairt(n) đôi, cặp
palacet(n) cung điện, lâu đài
palet(adj) tái, nhợt
pant(n) xoong, chảo
panel t(n) ván ô (cửa, tường), pa nô
pants t(n) quần lót, đùi
paper t(n) giấy
parallel	t(adj) song song, tương đương
parentt(n) cha, mẹ
parkt(n) (v) công viên, vườn hoa; khoanh vùng thành công viên
parliament t(n) nghi viện, quốc hội
partt(n) phần, bộ phận
take part inttham gia vào
particular t(adj) riêng biệt, cá biệt
particularlyt(adv) một cách đặc biệt, cá biệt, riêng biệt
partlyt(adv) đến chừng mực nào đó, phần nào đó
partner t(n)/ đối tác, cộng sự
partnershipt(n) sự chung phần, sự cộng tác
party t(n) tiệc, buổi liên hoan; đảng
passt(v) qua, vượt qua, ngang qua
passing t(n) (adj) sự đi qua, sự trôi qua; thoáng qua, ngắn ngủi
passage t(n) sự đi qua, sự trôi qua; hành lang
passengert(n) hành khách
passport	t(n) hộ chiếu
pastt(adj) (adv) quá khứ, dĩ vãng; quá, qua
patht(n) đường mòn; hướng đi
patience	t(n) tính kiên nhẫn, nhẫn nại, kiên trì, sự chịu đựng
patient t(n) (adj) bệnh nhân; kiên nhẫn, nhẫn nại, bền chí
pattern t(n) mẫu, khuôn mẫu
pause t(v) (n) tạm nghỉ, dừng; sự tạm nghỉ, sự tạm ngừng
payt(v) (n) trả, thanh toán, nộp; tiền lương
payment t(n) sự trả tiền, số tiền trả, tiền bồi thường
peace t(n) hòa bình, sự hòa thuận
peaceful	t(adj) hòa bình, thái bình, yên tĩnh
peakt(n) lưỡi trai; đỉnh, chóp
penny t(n) đồng xu, số tiền
pencilt(n) bút chì
pension t(n) tiền trợ cấp, lương hưu
peoplet(n) dân tộc, dòng giống; người
peppert(n) hạt tiêu, cây ớt
pert(prep) cho mỗi
percent t(n) phần trăm
perfect t(adj) hoàn hảo
perfectlyt(adv) một cách hoàn hảo
perform t(v) biểu diễn; làm, thực hiện
performancet(n) sự làm, sự thực hiện, sự thi hành, sự biểu diễn
performert(n) người biểu diễn, người trình diễn
perhaps t(adv) có thể, có lẽ
periodt(n) kỳ, thời kỳ, thời gian; thời đại
permanentt(adj) lâu dài, vĩnh cửu, thường xuyên
permanentlyt(adv) cách thường xuyên, vĩnh cửu
permission t(n) sự cho phép, giấy phép
permitt(v) /'pə:mit/ cho phép, cho cơ hội
persont(n) con người, người
personal	t(adj) cá nhân, tư, riêng tư
personally t(adv) đích thân, bản thân, về phần rôi, đối với tôi
personalityt(n) nhân cách, tính cách; nhân phẩm, cá tính
persuade	t(v) thuyết phục
pett(n) cơn nóng giận; vật cưng, người được yêu thích
petrolt(n) xăng dầu
phase t(n) tuần trăng; giai đoạn, thời kỳ
philosophy t(n) triết học, triết lý
photocopyt(n) (v) bản sao chụp; sao chụp
photograph t(n) (v) ảnh, bức ảnh; chụp ảnh
photographert(n) thợ chụp ảnh, nhà nhiếp ảnh
photographyt(n) thuật chụp ảnh, nghề nhiếp ảnh
phraset(n) câu; thành ngữ, cụm từ
physical	t(adj) vật chất; (thuộc) cơ thể, thân thể
physically t(adv) về thân thể, theo luật tự nhiên
physics t(n) vật lý học
pickt(v) cuốc (đất); đào, khoét (lỗ)
pick sth uptcuốc, vỡ, xé
picture t(n) bức vẽ, bức họa
piece t(n) mảnh, mẩu; đồng tiền
pilet(n) (v) cọc, chồng, đống, pin; đóng cọc, chất chồng
pillt(n) viên thuốc
pilot t(n) phi công
pint(n) (v) đinh ghim; ghim, kẹp
pinkt(adj) (n) màu hồng; hoa cẩm chướng, tình trạng tốt, hoàn hảo
pintt(n) Panh (đơn vị (đo lường) ở Anh bằng 0, 58 lít; ở Mỹ bằng 0, 473 lít)
pipet(n) ống dẫn (khí, nước...)
pitch t(n) sân (chơi các môn thể thao); đầu hắc ín
pityt(n) lòng thương hại, điều đáng tiếc, đáng thương
place t(n) (v) nơi, địa điểm; quảng trường
take place txảy ra, được cử hành, được tổ chức
plain t(adj) ngay thẳng, đơn giản, chất phác
plant(n) (v) bản đồ, kế hoạch; vẽ bản đồ, lập kế hoạch, dự kiến
planning	t(n) sự lập kế hoạch, sự quy hoạch
plane t(n) mặt phẳng, mặt bằng
planett(n) hành tinh
plant t(n) (v) thực vật, sự mọc lên; trồng, gieo
plastic t(n) (adj) chất dẻo, làm bằng chất dẻo
plate t(n) bản, tấm kim loại
platform	t(n) nền, bục, bệ; thềm, sân ga
pleasant	t(adj) vui vẻ, dễ thương; dịu dàng, thân mật
pleasantly t(adv) vui vẻ, dễ thương; thân mật
unpleasant t(adj) không dễ chịu, khó chịu, khó ưa
pleaset(v) làm vui lòng, vừa lòng, mong... vui lòng, xin mời
pleasing	t(adj) mang lại niềm vui thích; dễ chịu
pleased t(adj) hài lòng
pleasure	t(n) niềm vui thích, điều thích thú, điều thú vị; ý muốn, ý thích
plentytpro(n) (adv) (n) nhiều, sự thừa; sự sung túc, sự phong phú
plott(n) (v) mảnh đất nhở, sơ đồ, đồ thị, đồ án; vẽ sơ đồ, dựng đồ án
plugt(n) nút (thùng, chậu, bồn..)
plust(adj) (conj) cộng với (số, người...); dấu cộng; cộng,thêm vào
pockett(n) túi (quần áo, trong xe hơi), túi tiền
poemt(n) bài thơ
poetryt(n) thi ca; chất thơ
point t(n) (v) mũi nhọn, điểm; vót, làm nhọn, chấm (câu..)
pointed t(adj) nhọn, có đầu nhọn
poisont(n) (v) chất độc, thuốc độc; đánh thuốc độc, tẩm thuốc độc
poisonoust(adj) độc, có chất độc, gây chết, bệnh
polet(n) người Ba Lan; cực (nam châm, trái đất...)
policet(n) cảnh sát, công an
policyt(n) chính sách, cách xử sự, điều khoản, hợp đồng
polisht(n) (v) nước bóng, nước láng; đánh bóng, làm cho láng
politet(adj) lễ phép, lịch sự
politely	t(adv) lễ phép, lịch sự
politicalt(adj) về chính trị, về chính phủ, có tính chính trị
politicallyt(adv) về mặt chính trị; khôn ngoan, thận trọng; sảo quyệt
politician t(n) nhà chính trị, chính khách
politics	t(n) họat động chính trị, đời sống chính trị, quan điểm chính trị
pollutiont(n) sự ô nhiễm
poolt(n) vũng nước; bể bơi, hồ bơi
poort(adj) nghèo
popular t(adj) có tính đại chúng, (thuộc) nhân dân; được nhiều người ưa chuộng
population t(n) dân cư, dân số; mật độ dân số
portt(n) cảng
poset(v) (n) đưa ra, đề ra, đặt; sự đặt, đề ra
position	t(n) vị trí, chỗ
positive	t(adj) xác thực, rõ ràng, tích cực, lạc quan
possess t(v) có, chiếm hữu
possession t(n) quyền sở hữu, vật sở hữu
possibilityt(n) khă năng, triển vọng
possible	t(adj) có thể, có thể thực hiện
possibly	t(adv) có lẽ, có thể, có thể chấp nhận được
postt(n) (v) thư, bưu kiện; gửi thư
post officet(n) bưu điện
pott(n) can, bình, lọ...
potatot(n) khoai tây
potentialt(adj) (n) tiềm năng; khả năng, tiềm lực
potentiallyt(adv) tiềm năng, tiềm ẩn
pound t(n) pao - đơn vị đo lường
pourt(v) rót, đổ, giội
powdert(n) bột, bụi
power t(n) khả năng, tài năng, năng lực; sức mạnh, nội lực; quyền lực
powerful	t(adj) hùng mạnh, hùng cường
practicalt(adj) thực hành; thực tế
practicallyt(adv) về mặt thực hành; thực tế
practice	t(n) (v) thực hành, thực tiễn
practise	t(v) thực hành, tập luyện
praiset(n) (v) sự ca ngợi, sự tán dương, lòng tôn kính, tôn thờ; khen ngợi, tán dương
prayert(n) sự cầu nguyện
precise t(adj) rõ ràng, chính xác; tỉ mỉ, kỹ tính
preciselyt(adv) đúng, chính xác, cần thận
predict t(v) báo trước, tiên đoán, dự báo
prefert(v) thích hơn
preference t(n) sự thích hơn, sự ưa hơn; cái được ưa thích hơn
pregnant	t(adj) mang thai; giàu trí tưởng tượng, sáng tạo
premises	t(n) biệt thự
preparationt(n) sự sửa soạn, sự chuẩn bị
prepare t(v) sửa soạn, chuẩn bị
prepared	t(adj) đã được chuẩn bị
presence	t(n) sự hiện diện, sự có mặt; người, vât hiện diện
present t(n) (v) có mặt, hiện diện; hiện nay, hiện thời; bày tỏ, giới thiệu, trình bày
presentationt(n) bài thuyết trình, sự trình diện, sự giới thiệu
preserve	t(v) bảo quản, giữ gìn
presidentt(n) hiệu trưởng, chủ tịnh, tổng thống
press t(n) (v) sự ép, sự nén, sự ấn; ép, nén, bóp, ấn
pressure	t(n) sức ép, áp lực, áp suất
presumably t(adv) có thể được, có lẽ
pretend t(v) giả vờ, giả bộ, làm ra vẻ
prettyt(adv) (adj) khá, vừa phải; xinh, xinh xắn; đẹp
prevent t(v) ngăn cản, ngăn chặn, ngăn ngừa
previous	t(adj) vội vàng, hấp tấp; trước (vd. ngày hôm trước), ưu tiên
previously t(adv) trước, trước đây
price t(n) giá
pride t(n) sự kiêu hãnh, sự hãnh diện; tính kiêu căng, tự phụ
priestt(n) linh mục, thầy tu
primary t(adj) nguyên thủy, đầu tiên; thời cổ đại, nguyên sinh; sơ cấp, tiểu học
primarilyt(adv) trước hết, đầu tiên
prime ministert(n) thủ tướng
princet(n) hoàng tử
princess	t(n) công chúa
principlet(n) cơ bản, chủ yếu; nguyên lý, nguyên tắc
print t(v) (n) in, xuất bản; sự in ra
printing	t(n) sự in, thuật in, kỹ sảo in
printer t(n) máy in, thợ in
prior t(adj) trước, ưu tiên
priority	t(n) sự ưu tế, quyền ưu tiên
prisont(n) nhà tù
prisoner	t(n) tù nhân
private t(adj) cá nhân, riêng
privatelyt(adv) riêng tư, cá nhân
prize t(n) giải, giải thưởng
probable	t(adj) có thể, có khả năng
probably	t(adv) hầu như chắc chắn
problem t(n) vấn đề, điều khó giải quyết
proceduret(n) thủ tục
proceed t(v) tiến lên, theo đuổi, tiếp diễn
process t(n) (v) quá trình, sự tiến triển, quy trình; chế biến, gia công, xử lý
produce t(v) sản xuất, chế tạo
producer	t(n) nhà sản xuất
product t(n) sản phẩm
production t(n) sự sản xuất, chế tạo
profession t(n) nghề, nghề nghiệp
professionalt(adj) (n) (thuộc) nghề, nghề nghiệp; chuyên nghiệp
professort(n) giáo sư, giảng viên
profitt(n) thuận lợi, lợi ích, lợi nhuận
program t(n) (v) chương trình; lên chương trình
programmet(n) chương trình
progress	t(n) (v) sự tiến tới, sự tiến triển; tiến bộ, tiến triển, phát triển
project t(n) (v) đề án, dự án,kế hoạch; dự kiến, kế hoạch
promise t(v) (n) hứa, lời hứa
promote t(v) thăng chức, thăng cấp
promotiont(n) sự thăng chức, sự thăng cấp
promptt(adj) (v) mau lẹ, nhanh chóng; xúi, giục, nhắc nhở
promptly	t(adv) mau lẹ, ngay lập tức
pronouncet(v) tuyên bố, thông báo, phát âm
pronunciation t(n) sự phát âm
proof t(n) chứng, chứng cớ, bằng chứng; sự kiểm chứng
propert(adj) đúng, thích đáng, thích hợp
properly	t(adv) một cách đúng đắn, một cách thích đáng
property	t(n) tài sản, của cải; đất đai, nhà cửa, bất động sản
proportion t(n) sự cân xứng, sự cân đối
proposal	t(n) sự đề nghị, đề xuất
propose t(v) đề nghị, đề xuất, đưa ra
prospect	t(n) viễn cảnh, toàn cảnh; triển vọng, mong chờ
protect t(v) bảo vệ, che chở
protection t(n) sự bảo vệ, sự che chở
protest t(n) (v) sự phản đối, sự phản kháng; phản đối, phản kháng
proud t(adj) tự hào, kiêu hãnh
proudly t(adv) một cách tự hào, một cách hãnh diện
prove t(v) chứng tỏ, chứng minh
provide t(v) chuẩn bị đầy đủ, dự phòng; cung cấp, chu cấp
provided	t(conj) với điều kiện là, miễn là
pintt(n) panh (= 0, 58 lít (E);=0, 473 lít (A))
pubt(n) quán rượu, tiệm rượu
publict(adj) (n) chung, công cộng; công chúng, nhân dân
in publictgiữa công chúng, công khai
publicly	t(adv) công khai, công cộng
publicationt(n) sự công bố; sự xuất bản
publicityt(n) sự công khai, sự quảng cáo
publish t(v) công bố, ban bố; xuất bản
publishing t(n) công việc, nghề xuất bản
pullt(v) (n) lôi, kéo, giật; sự lôi kéo, sự giật
punch t(v) (n) đấm, thụi; quả đấm, cú thụi
punisht(v) phạt, trừng phạt
punishment t(n) sự trừng phạt, sự trừng trị
pupil t(n) học sinh
purchase	t(n) (v) sự mua, sự tậu; mua, sắm, tậu
puret(adj) nguyên chất, tinh khiết, trong lành
purelyt(adv) hoàn toàn, chỉ là
purplet(adj) (n) tía, có màu tía; màu tía
purpose t(n) mục đích, ý định
on purpose tcố tình, cố ý, có chủ tâm
pursuet(v) đuổi theo, đuổi bắt
pusht(v) (n) xô đẩy; sự xô đẩy
putt(v) đặt, để, cho vào
put sth on tmặc (áo), đội (mũ), đi (giày)
put sth outttắt, dập tắt
qualification t(n) phẩm chất, năng lực; khả năng chuyên môn
qualify t(v) đủ khả năng, đủ tư cách, điều kiện
qualifiedt(adj) đủ tư cách, điều kiện, khả năng
quality tn) chất lượng, phẩm chất
quantity	t(n) lượng, số lượng
quarter t(n) 1/4, 15 phút
question	t(n) (v) câu hỏi; hỏi, chất vấn
quick t(adj) nhanh
quickly t(adv) nhanh
quiet t(adj) lặng, yên lặng, yên tĩnh
quietly t(adv) lặng, yên lặng, yên tĩnh
quitt(v) thoát, thoát ra
quite t(adv) hoàn toàn, hầu hết
quote t(v) trích dẫn
racet(n) (v) loài, chủng, giống; cuộc đua; đua
racingt(n) cuộc đua
railt(n) đường ray
railway t(n) đường sắt
raise t(v) nâng lên, đưa lên, ngẩng lên
range t(n) dãy, hàng, loại; phạm vi, trình độ
rankt(n) (v) hàng, dãy; sắp xếp thành hàng, dãy
rapid t(adj) nhanh, nhanh chóng
rapidly t(adv) nhanh, nhanh chóng
raret(adj) hiếm, ít
rarelyt(adv) hiếm khi, ít khi
ratet(n) (v) tỷ lệ, tốc độ
rathert(adv) thà.. còn hơn, thích... hơn
rather thanthơn là
rawt(adj) sống (# chín), thô, còn nguyên chất
reach t(v) đến, đi đến, tới
react t(v) tác động trở lại, phản ứng
reaction	t(n) sự phản ứng; sự phản tác dụng
reading t(n) sự đọc
readert(n) người đọc, độc giả
ready t(adj) sẵn sàng
realt(adj) thực, thực tế, có thật
reallyt(adv) thực, thực ra, thực sự
realistict(adj) hiện thực
reality t(n) sự thật, thực tế, thực tại
realize t(v) thực hiện, thực hành
reart(n) (adj) phía sau; ở đằng sau, ở đằng sau
reasont(n) lý do, lý lẽ
reasonable t(adj) có lý, hợp lý
reasonably t(adv) hợp lý
unreasonablet(adj) vô lý
recallt(v) gọi về, triệu hồi; nhặc lại, gợi lại
receipt t(n) công thức; đơn thuốc
receive t(v) nhận, lĩnh, thu
recentt(adj) gần đây, mới đây
recently	t(adv) gần đây, mới đây
receptiont(n) sự nhận, sự tiếp nhận, sự đón tiếp
reckont(v) tính, đếm
recognitiont(n) sự công nhận, sự thừa nhận
recognizet(v) nhận ra, nhận diện; công nhận, thừa nhận
recommendt(v) giới thiệu, tiến cử; đề nghị, khuyên bảo
recordt(n) (v) bản ghi, sự ghi, bản thu, sự thu; thu, ghi chép
recordingt(n) sự ghi, sự thu âm
recover t(v) lấy lại, giành lại
reducet(v) giảm, giảm bớt
reductiont(n) sự giảm giá, sự hạ giá
refer to	t(v) xem, tham khảo; ám chỉ, nhắc đến
referencet(n) sự tham khảo, hỏi ý kiến
reflect t(v) phản chiếu, phản hồi, phản ánh
reformt(v) (n) cải cách, cải thiện, cải tạo; sự cải cách, sự cải thiện, cải tạo
refrigeratorttủ lạnh
refusal t(n) sự từ chối, sự khước từ
refuset(v) từ chối, khước từ
regardt(v) (n) nhìn, đánh giá; cái nhìn, sự quan tâm, sự chú ý (lời chúc tụng cuối thư)
regardingt(prep) về, về việc, đối với (vấn đề...)
regiont(n) vùng, miền
regional	t(adj) vùng, địa phương
register	t(v) (n) đăng ký, ghi vào sổ; sổ, sổ sách, máy ghi
regrett(v) (n) đáng tiếc, hối tiếc; lòng thương tiếc, sự hối tiếc
regular t(adj) thường xuyên, đều đặn
regularlyt(adv) đều đặn, thường xuyên
regulation t(n) sự điều chỉnh, điều lệ, quy tắc
rejectt(v) không chấp nhận, loại bỏ, bác bỏ
relatet(v) kể lại, thuật lại; liên hệ, liên quan
related to t(adj) có liên quan, có quan hệ với ai, cái gì
relation	t(n) mối quan hệ, sự liên quan, liên lạc
relationshipt(n) mối quan hệ, mối liên lạc
relative	t(adj) (n) có liên quan đến; người có họ, đại từ quan hệ
relatively t(adv) có liên quan, có quan hệ
relax t(v) giải trí, nghỉ ngơi
relaxed t(adj) thanh thản, thoải mái
relaxing	t(adj) làm giảm, bớt căng thẳng
release t(v) (n) làm nhẹ, bớt, thả, phóng thích, phát hành; sự giải thoát, thoát khỏi, sự thả
relevant	t(adj) thích hợp, có liên quan
relieft(n) sự giảm nhẹ, sự làm cho khuây khỏa; sự trợ cấo; sự đền bù
religion	t(n) tôn giáo
religioust(adj) (thuộc) tôn giáo
rely on t(v) tin vào, tin cậy, tin tưởng vào
remaint(v) còn lại, vẫn còn như cũ
remainingt(adj) còn lại
remains t(n) đồ thừa, cái còn lại
remarkt(n) (v) sự nhận xét, phê bình, sự để ý, chú ý; nhận xét, phê bình
remarkable t(adj) đáng chú ý, đáng để ý; khác thường
remarkably t(adv) đáng chú ý, đáng để ý; khác thường
remember	t(v) nhớ, nhớ lại
remindt(v) nhắc nhở, gợi nhớ
remotet(adj) xa, xa xôi, xa cách
removal t(n) viêc di chuyển, việc dọn nhà, dời đi
removet(v) dời đi, di chuyển
rentt(n) (v) sự thuê mướn; cho thuê, thuê
rentedt(adj) được thuê, được mướn
repairt(v) (n) sửa chữa, chỉnh tu; sự sửa chữa, sự chỉnh tu
repeatt(v) nhắc lại, lặp lại
repeated	t(adj) được nhắc lại, được lặp lại
repeatedly t(adv) lặp đi lặp lại nhiều lần
replace t(v) thay thế
reply t(n) (v) sự trả lời, sự hồi âm; trả lời, hồi âm
reportt(v) (n) báo cáo, tường trình; bản báo cáo, bản tường trình
representt(v) miêu tả, hình dung; đại diện, thay mặt
representativet(n) (adj) điều tiêu biểu, tượng trưng, mẫu; miêu tả, biểu hiện, đại diện
reproducet(v) tái sản xuất
reputation t(n) sự nổi tiếng, nổi danh
request t(n) (v) lời thỉnh cầu, lời đề nghị, yêu cầu; thỉnh cầu
require t(v) đòi hỏi, yêu cầu, quy định
requirementt(n) nhu cầu, sự đòi hỏi; luật lệ, thủ tục
rescuet(v) (n) giải thoát, cứu nguy; sự giải thoát, sự cứu nguy
research	t(n) sự nghiên cứu
reservationt(n) sự hạn chế, điều kiện hạn chế
reserve t(v) (n) dự trữ, để dành, đặt trước, đăng ký trước; sự dự trữ, sự để dành, sự đặt trước
resident	t(n) (adj) người sinh sống, trú ngụ, khách trọ; có nhà ở, cư trú, thường trú
resistt(v) chống lại, phản đổi, kháng cự
resistance t(n) sự chống lại, sự phản đối, sự kháng cự
resolve t(v) quyết định, kiên quyết (làm gì); giải quyết (vấn đề, khó khăn)
resortt(n) kế sách, phương kế
resource	t(n) tài nguyên; kế sách, thủ đoạn
respect t(n) (v) sự kính trọng, sự lễ phép; tôn trọng, kính trọng, khâm phục
respond t(v) hưởng ứng, phản ứng lại, trả lời
response	t(n) sự trả lời, câu trả lời, sự hưởng ứng, sự đáp lại
responsibilityt(n) trách nhiệm, sự chịu trách nhiệm
responsiblet(adj) chịu trách nhiệm về, chịu trách nhiệm trước ai,cái gì
restt(n) (v) sự nghỉ ngơi, lúc nghỉ; nghỉ, nghỉ ngơi
the rest	tvật, cái còn lại, những người, cái khác
restaurant t(n) nhà hàng ăn, hiệu ăn
restore t(v) hoàn lại, trả lại; sửa chữa lại, phục hồi lại
restrict	t(v) hạn chế, giới hạn
restricted t(adj) bị hạn chế, có giới hạn; vùng cấm
restrictiont(n) sự hạn chế, sự giới hạn
resultt(n) (v) kết quả; bởi, do.. mà ra, kết quả là...
retaint(v) giữ lại, nhớ được
retiret(v) rời bỏ, rút về; thôi, nghỉ việc, về hưu
retired t(adj) ẩn dật, hẻo lánh, đã về hưu, đã nghỉ việc
retirement t(n) sự ẩn dật, nơi hẻo lánh, sự về hưu, sự nghỉ việc
returnt(v) (n) trở lại, trở về; sự trở lại, sự trở về
revealt(v) bộc lộ, biểu lộ, tiết lộ; phát hiện, khám phá
reverse t(v) (n) đảo, ngược lại; điều trái ngược, mặt trái
reviewt(n) (v) sự xem lại, sự xét lại; làm lại, xem xét lại
reviset(v) đọc lại, xem lại, sửa lại, ôn lại
revision	t(n) sự xem lại, sự đọc lại, sự sửa lại, sự ôn lại
revolution t(n) cuộc cách mạng
rewardt(n) (v) sự thưởng, phần thưởng; thưởng, thưởng công
rhythmt(n) nhịp điệu
ricet(n) gạo, thóc, cơm; cây lúa
richt(adj) giàu, giàu có
ridt(v) giải thoát
get rid of ttống khứ
ridet(v) (n) đi, cưỡi (ngựa); sự đi, đường đi
ridingt(n) môn thể thao cưỡi ngựa, sự đi xe (bus, điện, xe đạp)
rider t(n) người cưỡi ngựa, người đi xe đạp
ridiculous t(adj) buồn cười, lố bịch, lố lăng
right t(adj) (adv) (n) thẳng, phải, tốt; ngay, đúng; điều thiện, điều phải, bên phải
rightly t(adv) đúng, phải, có lý
ringt(n) (v) chiếc nhẫn, đeo nhẫn cho ai
riset(n) (v) sự lên, sự tăng lương, thăng cấp; dậy, đứng lên, mọc (mặt trời), thành đạt
riskt(n) (v) sự liều, mạo hiểm; liều
rival t(n) (adj) đối thủ, địch thủ; đối địch, cạnh tranh
roadt(n) con đường, đường phố
robt(v) cướp, lấy trộm
rockt(n) đá
rolet(n) vai (diễn), vai trò
rollt(n) (v) cuốn, cuộn, sự lăn tròn; lăn, cuốn, quấn, cuộn
romantic	t(adj) lãng mạn
rooft(n) mái nhà, nóc
roott(n) gốc, rễ
ropet(n) dây cáp, dây thừng, xâu, chuỗi
rough t(adj) gồ ghề, lởm chởm
roughly t(adv) gồ ghề, lởm chởm
round t(adj) (adv) (n)tròn, vòng quanh, xung quanh
rounded t(adj) bị làm thành tròn; phát triển đầy đủ
route t(n) đường đi, lộ trình, tuyến đường
routine t(n) (adj) thói thường, lệ thường, thủ tục; thường lệ, thông thường
rowt(n) hàng, dãy
royal t(adj) (thuộc) vua, nữ hoàng, hoàng gia
rubt(v) cọ xát, xoa bóp, nghiền, tán
rubbert(n) cao su
rubbish t(n) vật vô giá trị, bỏ đi, rác rưởi
rudet(adj) bất lịch sự, thô lỗ; thô sơ, đơn giản
rudelyt(adv) bất lịch sự, thô lỗ; thô sơ, đơn giản
ruint(v) (n) làm hỏng, làm đổ nát, làm phá sản; sự hỏng, sự đổ nát, sự phá sản
ruinedt(adj) bị hỏng, bị đổ nát, bị phá sản
rulet(n) (v) quy tắc, điều lệ, luật lệ; cai trị, chỉ huy, điều khiển
ruler t(n) người cai trị, người trị vì; thước kẻ
rumourt(n) tin đồn, lời đồn
running t(n) sự chạy, cuộc chạy đua
runnert(n) người chạy
rural t(adj) (thuộc) nông thôn, vùng nông thôn
rusht(v) (n) xông lên, lao vào, xô đẩy; sự xông lên, sự lao vào, sự xô đẩy
sackt(n) (v) bào tải; đóng bao, bỏ vào bao
sadt(adj) buồn, buồn bã
sadly t(adv) một cách buồn bã, đáng buồn là, không may mà
sadness t(n) sự buồn rầu, sự buồn bã
safet(adj) an toàn, chắc chắn, đáng tin
safelyt(adv) an toàn, chắc chắn, đáng tin
safetyt(n) sự an toàn, sự chắc chăn
sailt(v) (n) đi tàu, thuyền, nhổ neo; buồm, cánh buồm, chuyến đi bằng thuyền buồm
sailing t(n) sự đi thuyền
sailort(n) thủy thủ
salad t(n) sa lát (xà lách trộng dầu dấm); rau sống
salaryt(n) tiền lương
salet(n) việc bán hàng
saltt(n) muối
salty t(adj) chứ vị muối, có muối, mặn
samet(adj) pro(n) đều đều, đơn điệu; cũng như thế, vẫn cái đó
samplet(n) mẫu, hàng mẫu
sandt(n) cát
satisfactiont(n) sự làm cho thỏa mãn, toại nguyện; sự trả nợ, bồi thường
satisfy t(v) làm thỏa mãn, hài lòng; trả (nợ), chuộc tội
satisfiedt(adj) cảm thấy hài lòng, vừa ý, thoả mãn
satisfying t(adj) đem lại sự thỏa mãn, làm thỏa mãn, làm vừa ý
sauce t(n) nước xốt, nước chấm
savet(v) cứu, lưu
savingt(n) sự cứu, sự tiết kiệm
scale t(n) vảy (cá..)
scare t(v) (n) làm kinh hãi, sợ hãi, dọa; sự sợ hãi, sự kinh hoàng
scaredt(adj) bị hoảng sợ, bị sợ hãi
scene t(n) cảnh, phong cảnh
schedule	t(n) (v) kế hoạch làm việc, bản liệt kê; lên thời khóa biểu, lên kế hoạch
schemet(n) sự sắp xếp, sự phối hợp; kế hoạch thực hiện; lược đồ, sơ đồ
schoolt(n) đàn cá, bầy cá, trường học
science t(n) khoa học, khoa học tự nhiên
scientific t(adj) (thuộc) khoa học, có tính khoa học
scientistt(n) nhà khoa học
scissors	t(n) cái kéo
score t(n) (v) điểm số, bản thắng, tỷ số; đạt được, thành công, cho điểm
scratch t(v) (n) cào, làm xước da; sự cào, sự trầy xước da
screamt(v) (n) gào thét, kêu lên; tiếng thét, tiếng kêu to
screent(n) màn che, màn ảnh, màn hình; phim ảnh nói chung
screw t(n) (v) đinh vít, đinh ốc; bắt vít, bắt ốc
sealt(n) (v) hải cẩu; săn hải cẩu
searcht(n) (v) sự tìm kiếm, sự thăm dò, sự điều tra; tìm kiếm, thăm dò, điều tra
seasont(n) mùa
seatt(n) ghế, chỗ ngồi
secondt(adv) (n) thứ hai, ở vị trí thứ 2, thứ nhì; người về nhì
secondaryt(adj) trung học, thứ yếu
secrett(adj) (n) bí mật; điều bí mật
secretly	t(adv) bí mật, riêng tư
secretaryt(n) thư ký
section t(n) mục, phần
sectort(n) khu vực, lĩnh vực
securet(adj) (v) chắc chắn, đảm bảo; bảo đảm, giữ an ninh
security	t(n) sự an toàn, sự an ninh
seet(v) nhìn, nhìn thấy, quan sát
seedt(n) hạt, hạt giống
seekt(v) tìm, tìm kiếm, theo đuổi,đòi hỏi
seemt(v) có vẻ như, dường như
selectt(v) chọn lựa, chọn lọc
selectiont(n) sự lựa chọn, sự chọc lọc
selft(n) bản thân mình
sellt(v) bán
senatet(n) thượng nghi viện, ban giám hiệu
senator t(n) thượng nghị sĩ
sendt(v) gửi, phái đi
seniort(adj) (n) nhiều tuổi hơn, dành cho trẻ em trên 11t, sinh viên năm cuối trường trung học, cao đẳng 
sense t(n) giác quan, tri giác, cảm giác
sensible	t(adj) có óc xét đoán; hiểu, nhận biết được
sensitivet(adj) dễ bị thương, dễ bị hỏng; dễ bị xúc phạm
sentence	t(n) câu
separate	t(adj) (v) khác nhau, riêng biệt; làm rời, tách ra, chia tay
separatedt(adj) ly thân
separately t(adv) không cùng nhau, thành người riêng, vật riêng
separation t(n) sự chia cắt, phân ly, sự chia tay, ly thân
seriest(n) loạt, dãy, chuỗi
serious t(adj) đứng đắn, nghiêm trang
seriouslyt(adv) đứng đắn, nghiêm trang
servant t(n) người hầu, đầy tớ
serve t(v) phục vụ, phụng sự
service t(n) sự phục vụ, sự hầu hạ
session t(n) buổi họp, phiên họp, buổi, phiên
sett(n) (v) bộ, bọn, đám, lũ; đặt để, bố trí
settlet(v) giải quyết, dàn xếp, hòa giải, đặt, bố trí
several t(adj) pro(n) nhiều hơn ba; vài; dăm ba, riêng; cá nhân
severet(adj) khắt khe, gay gắt; giản dị, mộc mạc
severely	t(adv) khắt khe, gay gắt; giản dị, mộc mạc
sewt(v) may, khâu
sewingt(n) sự khâu, sự may vá
sext(n) giới, giống
sexualt(adj) giới tính, các vấn đề sinh lý
sexually	t(adv) giới tính, các vấn đề sinh lý
shade t(n) bóng, bóng tối
shadowt(n) bóng, bóng tối, bóng râm, bóng má
shake t(v) (n) rung, lắc, giũ; sự rung, sự lắc, sự giũ
shall t(v) dự đoán tương lai: sẽ
shallow t(adj) nông, cạn
shame t(n) sự xấu hổ, thẹn thùng, sự ngượng
shape t(n) (v) hình, hình dạng, hình thù
shapedt(adj) có hình dáng được chỉ rõ
share t(v) (n) đóng góp, tham gia, chia sẻ; phần đóng góp, phần tham gia, chia sẻ
sharp t(adj) sắc, nhọn, bén
sharply t(adv) sắc, nhọn, bén
shave t(v) cạo (râu), bào, đẽo (gỗ)
sheep t(n) con cừu
sheet t(n) chăn, khăn trải giường; lá, tấm, phiến, tờ
shelf t(n) kệ, ngăn, giá
shell t(n) vỏ, mai; vẻ bề ngoài
shelter t(n) (v) sự nương tựa, sự che chở, sự ẩn náu; che chở, bảo vệ
shift t(v) (n) đổi chỗ, dời chỗ, chuyển, giao; sự thay đổi, sự luân phiên
shine t(v) chiếu sáng, tỏa sáng
shiny t(adj) sáng chói, bóng
shipt(n) tàu, tàu thủy
shirt t(n) áo sơ mi
shock t(v) (n) sự đụng chạm, va chạm, sự kích động, sự choáng
shocking	t(adj) gây ra căm phẫn, tồi tệ, gây kích động
shocked t(adj) bị kích động, bị va chạm, bị sốc
shoet(n) giày
shoot t(v) vụt qua, chạy qua, ném, phóng, bắn; đâm ra, trồi ra
shooting	t(n) sự bắn, sự phóng đi
shopt(n) (v) cửa hàng; đi mua hàng, đi chợ
shopping	t(n) sự mua sắm
short t(adj) ngắn, cụt
shortly t(adv) trong thời gian ngắn, sớm
shott(n) đạn, viên đạn
shoulder	t(n) vai
shout t(v) (n) hò hét, reo hò; sự la hét, sự hò reo
showt(v) (n) biểu diễn, trưng bày; sự biểu diễn, sự bày tỏ
showert(n) vòi hoa sen, sự tắm vòi hoa sen
shutt(v) (adj) đóng, khép, đậy; tính khép kín
shyt(adj) nhút nhát, e thẹn
sickt(adj) ốm, đau, bệnh
be sick tbị ốm
feel sicktbuồn nôn
sidet(n) mặt, mặt phẳng
sideways	t(adj) (adv) ngang, từ một bên; sang bên
sight t(n) cảnh đẹp; sự nhìn
signt(n) (v) dấu, dấu hiệu, kí hiệu; đánh dấu, viết ký hiệu
signalt(n) (v) dấu hiệu, tín hiệu; ra hiệu, báo hiệu
signaturet(n) chữ ký
significantt(adj) nhiều ý nghĩa, quan trọng
significantly t(adv) đáng kể
silence t(n) sự im lặng, sự yên tĩnh
silentt(adj) im lặng, yên tĩnh
silkt(n) tơ, chỉ, lụa
silly t(adj) ngớ ngẩn, ngu ngốc, khờ dại
silvert(n) (adj) bạc, đồng bạc; làm bằng bạc, trắng như bạc
similar t(adj) giống như, tương tự như
similarlyt(adv) tương tự, giống nhau
simplet(adj) đơn, đơn giản, dễ dàng
simplyt(adv) một cách dễ dàng, giản dị
since t(adv) từ, từ khi; từ khi, từ lúc đó; từ đó, từ lúc ấy
sincere t(adj) thật thà, thẳng thắng, chân thành
sincerelyt(adv) một cách chân thành
Yours sincerely tbạn chân thành của anh, chị.. (viết ở cuối thư)
singt(v) hát, ca hát
singing t(n) sự hát, tiếng hát
singert(n) ca sĩ
singlet(adj) đơn, đơn độc, đơn lẻ
sinkt(v) chìm, lún, đắm
sirt(n) xưng hô lịch sự Ngài, Ông
sitt(v) ngồi
sit down	tngồi xuống
sitet(n) chỗ, vị trí
situationt(n) hoàn cảnh, địa thế, vị trí
sizet(n) cỡ
sized tđã được định cỡ
skilful t(adj) tài giỏi, khéo tay
skilfullyt(adv) tài giỏi, khéo tay
skill t(n) kỹ năng, kỹ sảo
skilled t(adj) có kỹ năng, có kỹ sảo, khẻo tay; có kinh nghiệm, lành nghề
skint(n) da, vỏ
skirt t(n) váy, đầm
skyt(n) trời, bầu trời
sleep t(v) (n) ngủ; giấc ngủ
sleevet(n) tay áo, ống tay
slice t(n) (v) miếng, lát mỏng; cắt ra thành miếng mỏng, lát mỏng
slide t(v) trượtc, chuyển động nhẹ, lướt qua
slightt(adj) mỏng manh, thon, gầy
slightly	t(adv) mảnh khảnh, mỏng manh, yếu ớt
slipt(v) trượt, tuột, trôi qua, chạy qua
slope t(n) (v) dốc, đường dốc, độ dốc; nghiêng, dốc
slowt(adj) chậm, chậm chạp
slowlyt(adv) một cách chậm chạp, chậm dần
smart t(adj) mạnh, ác liệt,khéo léo, nhanh trí
smash t(v) (n) đập, vỡ tan thành mảnh; sự đập, vỡ tàn thành mảnh
smell t(v) (n) ngửi; sự ngửi, khứu giác
smile t(v) (n) cười, mỉm cười; nụ cười, vẻ tươi cười
smoke t(n) (v) khói, hơi thuốc; hút thuốc, bốc khói, hơi
smoking t(n) sự hút thuốc
smootht(adj) nhẵn, trơn, mượt mà
smoothly	t(adv) một cách êm ả, trôi chảy
snake t(n) con rắn; người nham hiểm, xảo trá
snowt(n) (v) tuyết; tuyết rơi
so t(adv) (conj) như vậy, như thế; vì thế, vì vậy, vì thế cho nên
so that tđể, để cho, để mà
soapt(n) xà phòng
socialt(adj) có tính xã hội
socially	t(adv) có tính xã hội
society t(n) xã hội
sockt(n) tất ngắn, miếng lót giày
softt(adj) mềm, dẻo
softlyt(adv) một cách mềm dẻo
software	t(n) phần mềm (máy tính)
soilt(n) đất trồng; vết bẩn
soldier t(n) lính, quân nhân
solid t(adj) (n) rắn; thể rắn, chất rắn
solution	t(n) sự giải quyết, giải pháp
solve t(v) giải, giải thích, giải quyết
sometpro(n) một it, một vài
somehow t(adv) không biết làm sao, bằng cách này hay cách khác
somebody	tpro(n) người nào đó
somethingtpro(n) một điều gì đó, một việc gì đó, một cái gì đó
sometimest(adv) thỉnh thoảng, đôi khi
somewhat	t(adv) đến mức độ nào đó, hơi, một chút
somewheret(adv) nơi nào đó. đâu đó
soont(adv) sớm, chẳng bao lâu nữa
as soon as tngay khi
soret(adj) đau, nhức
sorry t(adj) xin lỗi, lấy làm tiếc, lấy làm buồn
sortt(n) (v) thứ, hạng loại; lựa chọn, sắp xếp, phân loại
soult(n) tâm hồn, tâm trí, linh hồn
sound t(n) (v) âm thanh; nghe
soupt(n) xúp, canh, cháo
sourt(adj) chua, có vị giấm
sourcet(n) nguồn
south t(n) (adj) (adv) phương Nam, hướng Nam; ở phía Nam
southern	t(adj) thuộc phương Nam
space t(n) khoảng trống, khoảng cách
spare t(adj) (n) thừa thãi, dự trữ, rộng rãi; đồ dự trữ, đồ dự phòng
speak t(v) nói
spokent(adj) nói theo 1 cách nào đó
speaker t(n) người nói, người diễn thuyết
special t(adj) đặc biệt, riêng biệt
speciallyt(adv) đặc biệt, riêng biệt
specialist t(n) chuyên gia, chuyên viên
specific	t(adj) đặc trưng, riêng biệt
specificallyt(adv) đặc trưng, riêng biệt
speecht(n) sự nói, khả năng nói, lời nói, cách nói, bài nói
speed t(n) tốc độ, vận tốc
spell t(v) (n) đánh vần; sự thu hút, sự quyến rũ, say mê
spelling	t(n) sự viết chính tả
spend t(v) tiêu, xài
spice t(n) gia vị
spicy t(adj) có gia vị
spidert(n) con nhện
spint(v) quay, quay tròn
spiritt(n) tinh thần, tâm hồn, linh hồn
spiritualt(adj) (thuộc) tinh thần, linh hồn
spite t(n) sự giận, sự hận thù
in spite oftmặc dù, bất chấp
split t(v) (n) chẻ, tách, chia ra; sự chẻ, sự tách, sự chia ra
spoil t(v) cướp, cướp đọat
spoon t(n) cái thìa
spott(n) dấu, đốm, vết
spray t(n) (v) máy, ống, bình phụt, bơm, phun; bơm, phun, xịt
spreadt(v) trải, căng ra, bày ra; truyền bá
springt(n) mùa xuân
squaret(adj) (n) vuông, vuông vắn; dạng hình vuông, hình vuông
squeeze t(v) (n) ép, vắt, xiết; sự ép, sự vắt, sự xiết
stablet(adj) (n) ổn định, bình tĩnh, vững vàng; chuồng ngưa
staff t(n) gậy quyền, quyền trượng, nhân viên, cán bộ
stage t(n) tầng, bệ
stair t(n) bậc thang
stamp t(n) (v) tem; dán tem
stand t(v) (n) đứng, sự đứng
stand up	tđứng dậy
standard	t(n) (adj) tiêu chuẩn, chuẩn, mãu; làm tiêu chuẩn, phù hợp với tiêu chuẩn
start(n) (v) ngôi sao, dán sao, trang trí hình sao, đánh dấu sao
stare t(v) (n) nhìn chằm chằm; sự nhìn chằm chằm
start t(v) (n) bắt đầu, khởi động; sự bắt đầu, sự khởi đầu, khởi hành
state t(n) (adj) (v) nhà nước, quốc gia, chính quyền; (thuộc) nhà nước, phát biểu
statementt(n) sự bày tỏ, sự phát biểu; sự tuyên bố, sự trình bày
station t(n) trạm, điểm, đồn
statuet(n) tượng
statust(n) tình trạng, địa vị, thân phận
stayt(v) (n) ở lại, lưu lại; sự ở lại, sự lưu lại
steadyt(adj) vững chắc, vững vàng, kiến định
steadily	t(adv) vững chắc, vững vàng, kiên định
unsteady	t(adj) không đúng mực, không chắc, không vững
steal t(v) ăn cắp, ăn trộm
steam t(n) hơi nước
steel t(n) thép, ngành thép
steep t(adj) dốc, dốc đứng
steeply t(adv) dốc, cheo leo
steer t(v) lái (tàu, ô tô...), hướng dẫn; hướng theo
stept(n) (v) bước; bước, bước đi
stick t(v) (n) đâm, thọc, chọc, cắm, dính; cái gậy, qua củi, cán
stick out for tđòi, đạt được cái gì
stickyt(adj) dính, nhớt
stiff t(adj) cứng, cứng rắn, kiên quyết
stiffly t(adv) cứng, cứng rắn, kiên quyết
still t(adv) (adj) đứng yên; vẫn, vẫn còn
sting t(v) (n) châm, chích, đốt; ngòi, vòi (ong, muỗi), nọc (rắn); sự châm, chích
stirt(v) khuấy, đảo
stock t(n) kho sự trữ, hàng dự trữ, vốn
stomach t(n) dạ dày
stone t(n) đá
stopt(v) (n) dừng, ngừng, nghỉ, thôi; sự dừng, sự ngừng, sự đỗ lại
store t(n) (v) cửa hàng, kho hàng; tích trữ, cho vào kho
storm t(n) cơn giông, bão
story t(n) chuyện, câu chuyện
stove t(n) bếp lò, lò sưởi
straight	t(adv) (adj) thẳng, không cong
straint(n) sự căng thẳng, sự căng
strange t(adj) xa lạ, chưa quen
strangelyt(adv) lạ, xa lạ, chưa quen
stranger	t(n) người lạ
strategy	t(n) chiến lược
streamt(n) dòng suối
streett(n) phố, đườmg phố
strength	t(n) sức mạnh, sức khỏe
stresst(n) (v) sự căng thẳng; căng thẳng, ép, làm căng
stressed	t(adj) bị căng thẳng, bị ép, bị căng
stretch t(v) căng ra, duỗi ra, kéo dài ra
strictt(adj) nghiêm khắc, chặt chẽ, khắt khe
strictly	t(adv) một cách nghiêm khắc
striket(v) (n) đánh, đập, bãi công, đình công; cuộc bãi công, cuộc đình công
striking	t(adj) nổi bật, gây ấn tượng
stringt(n) dây, sợi dây
strip t(v) (n) cởi, lột (quần áo); sự cởi quần áo
stripet(n) sọc, vằn, viền
striped t(adj) có sọc, có vằn
stroket(n) (v) cú đánh, cú đòn; cái vuốt ve, sự vuốt ve; vuốt ve
strongt(adj) khỏe, mạnh, bền, vững, chắc chắn
strongly	t(adv) khỏe, chắc chắn
structuret(n) kết cấu, cấu trúc
struggle	t(v) (n) đấu tranh; cuộc đấu tranh, cuộc chiến đấu
studiot(n) xưởng phim, trường quay; phòng thu
study t(n) (v) sự học tập, sự nghiên cứu; học tập, nghiên cứu
stuff t(n) chất liệu, chất
stupidt(adj) ngu ngốc, ngu đần, ngớ ngẩn
style t(n) phong cách, kiểu, mẫu, loại
subject t(n) chủ đề, đề tài; chủ ngữ
substancet(n) chất liệu; bản chất; nội dung
substantialt(adj) thực tế, đáng kể, quan trọng
substantially t(adv) về thực chất, về căn bản
substitute t(n) (v) người, vật thay thế; thay thế
succeed t(v) nối tiếp, kế tiếp; kế nghiệp, kế vị
success t(n) sự thành công, sự thành đạt
successful t(adj) thành công, thắng lợi, thành đạt
successfullyt(adv) thành công, thắng lợi, thành đạt
unsuccessfult(adj) không thành công, thất bại
suchtpro(n) như thế, như vậy, như là
such as tđến nỗi, đến mức
suckt(v) bú, hút; hấp thụ, tiếp thu
suddent(adj) thình lình, đột ngột
suddenly	t(adv) thình lình, đột ngột
suffert(v) chịu đựng, chịu thiệt hại, đau khổ
sufferingt(n) sự đau đớn, sự đau khổ
sufficient fort(adj) đủ, thích đáng
sufficientlyt(adv) đủ, thích đáng
sugar t(n) đường
suggest t(v) đề nghị, đề xuất; gợi
suggestion t(n) sự đề nghị, sự đề xuất, sự khêu gợi
suitt(n) (v) bộ com lê, trang phục; thích hợp, quen, hợp với
suitedt(adj) hợp, phù hợp, thích hợp với
suitable	t(adj) hợp, phù hợp, thích hợp với
suitcase	t(n) va li
sumt(n) tổng, toàn bộ
summary t(n) bản tóm tắt
summert(n) mùa hè
superior	t(n) (adj) cao hơn, mạnh hơn,người cấp trên,thượng cấp
supermarkett(n) siêu thị
supplyt(n) (v) sự cung cấp, nguồn cung cấp; cung cấp, đáp ứng, tiếp tế
support t(n) (v) sự chống đỡ, sự ủng hộ; chống đỡ, ủng hộ
supportert(n) vật chống đỡ; người cổ vũ, người ủng hộ
suppose t(v) cho rằng, tin rằng, nghĩ rằng
suret(adj) (adv) chắc chắn, xác thực
make suretchắc chắn, làm cho chắc chắn
surelyt(adv) chắc chắn
surface t(n) mặt, bề mặt
surname t(n) họ
surprise	t(n) (v) sự ngạc nhiên, sự bất ngờ; làm ngạc nhiên
surprising t(adj) làm ngạc nhiên, làm bất ngờ
surprisinglyt(adv) làm ngạc nhiên, làm bất ngờ
surprised att(adj) ngạc nhiên
surround	t(v) vây quanh, bao quanh
surroundingt(adj) bao quanh, vây quanh; ngoại vi
surroundingst(n) vùng xung quanh, môi trường xung quanh
surveyt(n) (v) sự nhìn chung, sự khảo sát; quan sát, nghiên cứu
survive t(v) sống lâu hơn, tiếp tục sống, sống sót
suspect t(v) (n) nghi ngờ, hoài nghi; người khả nghi, người bị tình nghi
suspiciont(n) sự nghi ngờ, sự ngờ vực
suspicious t(adj) có sự nghi ngờ, tỏ ra nghi ngờ, khả nghi
swallow t(v) nuốt, nuốt chửng
swear t(v) chửi rủa, nguyền rủa; thề, hứa
swearing	t(n) lời thề, lời nguyền rủa, lời thề hứa
sweat t(n) (v) mồ hôi; đổ mồ hô
sweater t(n) người ra mồ hôi,kẻ bóc lột lao động
sweep t(v) quét
sweet t(adj) (n) ngọt, có vị ngọt; sự ngọt bùi, đồ ngọt
swell t(v) phồng, sưng lên
swelling	t(n) sự sưng lên, sự phồng ra
swollen t(adj) sưng phồng, phình căng
swimt(v) bơi lội
swimming	t(n) sự bơi lội
swimming pool t(n) bể nước
swing t(n) (v) sự đu đưa, lúc lắc; đánh đu, đu đưa, lúc lắc
switcht(n) (v) công tắc, roi; tắt, bật, đánh bằng gậy, roi
switch sth offtngắt điện
switch sth on tbật điện
swell t(v) phồng lên, sưng lên
symbolt(n) biểu tượng, ký hiệu
sympathetict(adj) đồng cảm, đáng mến, dễ thương
sympathy	t(n) sự đồng cảm, sự đồng ý
systemt(n) hệ thống, chế độ
table t(n) cái bàn
tablett(n) tấm, bản, thẻ phiến
tacklet(v) (n) giải quyết, khắc phục, bàn thảo; đồ dùng,dụng cụ
tailt(n) đuôi, đoạn cuối
taket(v) sự cầm nắm, sự lấy
take sth offtcởi, bỏ cái gì, lấy đi cái gì
take sth over tchở, chuyển cái gì; tiếp quản, kế tục cái gì
talkt(v) (n) nói chuyện, trò chuyện; cuộc trò chuyện, cuộc thảo luận
tankt(n) thùng, két, bể
tapt(v) (n) mở vòi, đóng vồi; vòi, khóa
tapet(n) băng, băng ghi âm; dải, dây
targett(n) bia, mục tiêu, đích
taskt(n) nhiệm vụ, nghĩa vụ, bài tập, công tác, công việc
taste t(n) (v) vị, vị giác; nếm
taxt(n) (v) thuế; đánh thuế
teat(n) cây chè, trà, chè
teach t(v) dạy
teaching	t(n) sự dạy, công việc dạy học
teacher t(n) giáo viên
teamt(n) đội, nhóm
teart(v) (n) xé, làm rắch; chỗ rách, miếng xe; nước mắt
technicalt(adj) (thuộc) kỹ thuật, chuyên môn
techniquet(n) kỹ sảo, kỹ thuật, phương pháp kỹ thuật
technology t(n) kỹ thuật học, công nghệ học
telephonet(n) (v) máy điện thoại, gọi điện thoại
television t(n) vô tuyến truyền hình
tellt(v) nói, nói với
temperaturet(n) nhiệt độ
temporaryt(n) tạm thời, nhất thời, lâm thời
temporarilyt(adv) tính chất tạm thời, nhất thời
tendt(v) trông nom, chăm sóc, giữ gìn, hầu hạ
tendency	t(n) xu hướng, chiều hướng, khuynh hướng
tension t(n) sự căng, độ căng, tình trạng căng
tentt(n) lều, rạp
termt(n) giới hạn, kỳ hạn, khóa, kỳ học
terrible	t(adj) khủng khiếp, ghê sợ
terribly	t(adv) tồi tệ, không chịu nổi
testt(n) (v) bài kiểm tra, sự thử nghiệm, xét nghiệm; kiểm tra
textt(n) nguyên văn, bản văn, chủ đề, đề tài
thant(conj) hơn
thank t(v) cám ơn
thankst(n) sự cảm ơn, lời cảm ơn
thattpro(n) (conj) người ấy, đó, vật ấy, đó; rằng, là
thetcái, con, người, ấy này, duy nhất
theatre t(n) rạp hát, nhà hát
theme t(n) đề tài, chủ đề
themselves tpro(n) tự chúng, tự họ, tự
thent(adv) khi đó, lúc đó, tiếp đó
theoryt(n) lý thuyết, học thuyết
there t(adv) ở nơi đó, tại nơi đó
thereforet(adv) bởi vậy, cho nên, vì thế
thick t(adj) dày; đậm
thickly t(adv) dày; dày đặc; thành lớp dày
thicknesst(n) tính chất dày, độ dày, bề dày
thief t(n) kẻ trộm, kẻ cắp
thint(adj) mỏng, mảnh
thing t(n) cái, đồ, vật
think t(v) nghĩ, suy nghĩ
thinking	t(n) sự suy nghĩ, ý nghĩ
thirsty t(adj) khát, cảm thấy khát
thistpro(n) cái này, điều này, việc này
thorough	t(adj) cẩn thận, kỹ lưỡng
thoroughly t(adv) kỹ lưỡng, thấu đáo, triệt để
thought(adv) dù, dù cho, mặc dù; mặc dù, tuy nhiên, tuy vậy
thought t(n) sự suy nghĩ, khả năng suy nghĩ; ý nghĩ, tư tưởng, tư duy
threadt(n) chỉ, sợi chỉ, sợi dây
threatt(n) sự đe dọa, lời đe dọa
threaten	t(v) dọa, đe dọa
threateningt(adj) sự đe dọa, sự hăm dọa
throatt(n) cổ, cổ họng
through t(adv) qua, xuyên qua
throughout t(adv) khắp nơi, từ đầu đến cuối, suốt
throw t(v) ném, vứt, quăng
throw sth awaytném đi, vứt đi, liệng đi
thumb t(n) ngón tay cái
thust(adv) như vậy, như thế, do đó
tickett(n) vé
tidyt(adj) (v) sạch sẽ, ngăn nắp, gọn gàng
untidyt(adj) không gọn gàng, không ngăn nắp, lộn xộn
tiet(v) (n) buộc, cột, trói; dây buộc, dây trói, dây giày
tie sth up tcó quan hệ mật thiết, gắn chặt
tight t(adj) (adv) kín, chặt, chật
tightly t(adv) chặc chẽ, sít sao
tilltcho đến khi, tới lúc mà
timet(n) thời gian, thì giờ
timetablet(n) kế hoạch làm việc, thời gian biểu
tint(n) thiếc
tinyt(adj) rất nhỏ, nhỏ xíu
tipt(n) (v) đầu, mút, đỉnh, chóp; bịt đầu, lắp đầu vào
tiret(v) (n) làm mệt mỏi, trở nên mệt nhọc; lốp, vỏ xe
tiringt(adj) sự mệt mỏi, sự mệt nhọc
tired t(adj) mệt, muốn ngủ, nhàm chán
title t(n) đầu đề, tiêu đề; tước vị, tư cách
toet(n) ngón chân (người)
together	t(adv) cùng nhau, cùng với
toilett(n) nhà vệ sinh; sự trang điểm (rửa mặt, ăn mặc, chải tóc...)
tomatot(n) cà chua
tomorrow	t(adv) (n) vào ngày mai; ngày mai
tont(n) tấn
tonet(n) tiếng, giọng
tonguet(n) lưỡi
tonne t(n) tấn
toolt(n) dụng cụ, đồ dùng
tooth t(n) răng
topt(n) (adj) chóp, đỉnh; đứng đầu, trên hết
topic t(n) đề tài, chủ đề
total t(adj) (n) tổng cộng, toàn bộ; tổng số, toàn bộ số lượng
totally t(adv) hoàn toàn
touch t(v) (n) sờ, mó, tiếp xúc; sự sờ, sự mó, sự tiếp xúc
tough t(adj) chắc, bền, dai
tourt(n) (v) cuộc đi du lịch, cuộc đi dạo, chuyến du lịch; đi du lịch
tourist t(n) khách du lịch
towards t(prep) theo hướng, về hướng
towel t(n) khăn tắm, khăn lau
tower t(n) tháp
townt(n) thị trấn, thị xã, thành phố nhỏ
toyt(n) (adj) đồ chơi, đồ trang trí; thể loại đồ chơi
trace t(v) (n) phát hiện, tìm thấy, vạch, chỉ ra, phác họa; dấu, vết
track t(n) phần của đĩa; đường mòn, đường đua
trade t(n) (v) thương mại, buôn bán; buôn bán, trao đổi
trading t(n) sự kinh doanh, việc mua bán
traditiont(n) truyền thống
traditionalt(adj) theo truyền thống, theo lối cổ
traditionally t(adv) (thuộc) truyền thống, là truyền thống
traffic t(n) sự đi lại, sự giao thông, sự chuyển động
train t(n) (v) xe lửa, tàu hỏa; dạy, rèn luyện, đào tạo
training	t(n) sự dạy dỗ, sự huấn luyện, sự đào tạo
transfer	t(v) (n) dời, di chuyển; sự di chuyển, sự dời chỗ
transformt(v) thay đổi, biến đổi
translatet(v) dịch, biên dịch, phiên dịch
translationt(n) sự dịch
transparentt(adj) trong suốt; dễ hiểu, sáng sủa
transportt(v) (n) sự vận chuyển, sự vận tải;chuyên chở, phương tiện đi lại
trapt(n) (v) đồ đạc, hành lý; bẫy, cạm bãy; bẫy, giữ, chặn lạ
travelt(v) (n) đi lại, đi du lịch, di chuyển; sự đi, những chuyến đi
travellert(n) người đi, lữ khách
treat t(v) đối xử, đối đãi, cư xử
treatmentt(n) sự đối xử, sự đối đãi, sự cư xử (với người nào)
trend t(n) phương hướng, xu hướng, chiều hướng
trial t(n) sự thử nghiệm, cuộc thử nghiệm
triangle	t(n) hình tam giác
trick t(n) (v) mưu mẹo, thủ đoạn, trò lừa gạt; lừa, lừa gạt
tript(n) (v) cuộc dạo chơi, cuộc du ngoạn; đi dạo, du ngoạn
tropical	t(adj) nhiệt đới
trouble t(n) điều lo lắng, điều muộn phiền
trousers	t(n) quần
truck t(n) rau quả tươi
truet(adj) đúng, thật
truly t(adv) đúng sự thật, đích thực, thực sự
yours trulytlời kết thúc thư (bạn chân thành của...)
trust t(n) (v) niềm tin, sự phó thác; tin, tin cậy, phó thác
truth t(n) sự thật
tryt(v) thử, cố gắng
tubet(n) ống, tuýp
tuesday tthứ 3
tunet(n) (v) điệu, giai điệu; lên dây, so dây (đàn)
tunnelt(n) đường hầm, hang
turnt(v) (n) quay, xoay, vặn; sự quay, vòng quay
twice t(adv) hai lần
twint(n) (adj) sinh đôi, tạo thành cặp; cặp song sinh
twist t(v) (n) xoắn, cuộn, quắn; sự xoắn, vòng xoắn
twisted t(adj) được xoắn, được cuộn
typet(n) (v) loại, kiểu, mẫu; phân loại, xếp loại
typical t(adj) tiêu biểu, điển hình, đặc trưng
typicallyt(adv) điển hình, tiêu biểu
tyret(n) lốp, vỏ xe
uglyt(adj) xấu xí, xấu xa
ultimate	t(adj) cuối cùng, sau cùng
ultimately t(adv) cuối cùng, sau cùng
umbrella	t(n) ô, dù
unablet(adj) không thể, không có khẳ năng
unacceptablet(adj) không thể chấp nhận
uncertaint(adj) không chắc chắn, khôn biết rõ ràng
uncle t(n) chú, bác
uncomfortable t(adj) bất tiện, không tiện lợi
unconscioust(adj) bất tỉnh, ngất đi
uncontrolledt(adj) không bị kiềm chế, không bị kiểm tra
under t(adv) dưới, ở dưới; ở phía dưới, về phía dưới
undergroundt(adj) (adv) dưới mặt đất, ngầm dưới đất; ngầm
underneath t(prep) (adv) dưới, bên dưới
understand t(v) hiểu, nhận thức
understanding t(n) trí tuệ, sự hiểu biết
underwater t(adj) (adv) ở dưới mặt nước, dưới mặt nước
undottháo, gỡ, xóa, hủy bỏ
underweart(n) quần lót
unemployed t(adj) không dùng, thất nghiệp
unemploymentt(n) sự thất nghiệp, tình trạng thất nghiệp
unexpected t(adj) bất ngờ, đột ngột, gây ngạc nhiên
unexpectedlyt(adv) bất ngờ, đột ngột, gây ngạc nhiên
unfairt(adj) gian lận, không công bằng; bất lợi
unfairly	t(adv) gian lận, không công bằng; bất lợi
unfortunatet(adj) không may, rủi ro, bất hạnh
unfortunately t(adv) một cách đáng tiếc, một cách không may
unfriendly tđối địch, không thân thiện
unhappinesst(n) nỗi buồn, sự bất hạnh
unhappy t(adj) buồn rầu, khốn khổ
uniform t(n) (adj) đồng phục; đều, giống nhau, đồng dạng
unimportantt(adj) không quan trọng
union t(n) liên hiệp, sự đoàn kết, sự hiệp nhất
uniquet(adj) độc nhất vô nhị
unitt(n) đơn vị
unite t(v) liên kết, hợp nhất, hợp lại, kết thân
unitedt(adj) liên minh, đoàn kết, chung, thống nhất
universe	t(n) vũ trụ
university t(n) trường đại học
unkindt(adj) không tốt, độc ác, tàn nhẫn
unknown t(adj) không biết, không được nhận ra
unlesst(conj) trừ phi, trừ khi, nếu không
unliketkhông giống, khác
unlikely	t(adj) không có thể xảy ra, không chắc chắn; không có thực
unloadt(v) tháo, dỡ
unlucky t(adj) không gặp may, bất hạnh
unnecessaryt(adj) không cần thiết, không mong muốn
unpleasant t(adj) không dễ chịu, khó chịu
unreasonablet(adj) vô lý
unsteady	t(adj) không đúng mực, không chắc, không vững
unsuccessfult(adj) không thành công, thất bại
untidyt(adj) không gọn gàng, không ngăn nắp, lộn xộn
until t(conj) (prep) trước khi, cho đến khi
unusual thiếm, khác thường
unwillingt(adj) không muốn làm điều gì; miễn cưỡng; bất đắc dĩ
unwillinglyt(adv) miễn cưỡng; bất đắc dĩ
up t(adv) (prep) ở trên, lên trên, lên
upont(prep) trên, ở trên
upper t(adj) cao hơn
upset t(v) (adj) làm đổ, đánh đổ
upsettingt(adj) tính đánh đổ, làm đổ
upside downt(adv) lộn ngược
upstairs	t(adv) (adj) (n) ở tên gác, cư ngụ ở tầng gác; tầng trên
upwardt(adj) lên, hướng lên, đi lên
urban t(adj) (thuộc) thành phố, khu vực
urget(v) (n) thúc, giục, giục giã; sự thúc đẩy, sự thôi thúc
urgentt(adj) gấp, khẩn cấp
uset(v) (n) sử dụng, dùng; sự dùng, sự sử dụng
usedt(adj) đã dùng, đã sử dụng
used to sthtsử dụng cái gì, sử dụng để làm cái gì
used to doing sthtsử dụng gì, sử dụng để làm gì
used to t(v) đã quen dùng
usefult(adj) hữu ích, giúp ích
useless t(adj) vô ích, vô dụng
usert(n) người dùng, người sử dụng
usual t(adj) thông thường, thường dùng
usually t(adv) thường thường
unusual t(adj) hiếm, khác thường, đáng chú ý
unusuallyt(adv) cực kỳ, khác thường
vacation	t(n) kỳ nghỉ hè, kỳ nghỉ lễ; ngày nghỉ, ngày lễ
valid t(adj) chắc chắn, hiệu quả, hợp lý
valleyt(n) thung lũng
valuable	t(adj) có giá trị lớn, đáng giá
value t(n) (v) giá trị, ước tính, định giá
vant(n) tiền đội, quân tiên phong; xe tải
variationt(n) sự biến đổi, sự thay đổi mức độ, sự khác nhau
variety t(n) sự đa dạng, trạng thái khác nhau
various t(adj) khác nhau, thuộc về nhiều loại
varyt(v) thay đổi, làm cho khác nhau, biến đổi
variedt(adj) thuộc nhiều loại khác nhau, những vẻ đa dạng
vastt(adj) rộng lớn, mênh mông
vegetablet(n) rau, thực vật
vehicle t(n) xe cộ
venture t(n) (v) sự án kinh doanh, công việc kinh doanh; liều, mạo hiểm, cả gan
version t(n) bản dịch sang một ngôn ngữ khác
vertical	t(adj) thẳng đứng, đứng
viat(prep) qua, theo đường
victimt(n) nạn nhân
victory t(n) chiến thắng
video t(n) video
viewt(n) (v) sự nhìn, tầm nhìn; nhìn thấy, xem, quan sát
village t(n) làng, xã
violence	t(n) sự ác liệt, sự dữ dội; bạo lực
violent t(adj) mãnh liệt, mạnh mẽ, hung dữ
violentlyt(adv) mãnh liệt, dữ dội
virtuallyt(adv) thực sự, hầu như, gần như
virus t(n) vi rút
visible t(adj) hữu hình, thấy được
visiont(n) sự nhìn, thị lực
visit t(v) (n) đi thăm hỏi, đến chơi, tham quan; sự đi thăm,
visitor t(n) khách, du khách
vital t(adj) (thuộc) sự sống, cần cho sự sống
vocabulary t(n) từ vựng
voice t(n) tiếng, giọng nói
volumet(n) thế tích, quyển, tập
votet(n) (v) sự bỏ phiếu, sự bầu cử; bỏ phiếu, bầu cử
waget(n) tiền lương, tiền công
waist t(n) eo, chỗ thắt lưng
waitt(v) chờ đợi
waitert(n) người hầu bàn, người đợi, người trông chờ
waitress	t(n) người nữ hầu bàn
waket(v) thức dậy, tỉnh thức
walkt(v) (n) đi, đi bộ; sự đi bộ, sự đi dạo
walking t(n) sự đi, sự đi bộ
wallt(n) tường, vách
wallett(n) cái ví
wandert(v) (n) đi lang thang; sự đi lang thang
wantt(v) muốn
wart(n) chiến tranh
warmt(adj) (v) ấm, ấm áp; làm cho nóng, hâm nóng
warmtht(n) trạng thái ấm, sự ấm áp; hơi ấm
warnt(v) báo cho biết, cảnh báo
warning t(n) sự báo trước, lời cảnh báo
washt(v) rửa, giặt
washing t(n) sự tắm rửa, sự giặt
waste t(v) (n) (adj) lãng phí, uổng phí; vùng hoang vu, sa mạc; bỏ hoang
watch t(v) (n) đồng hồ, nhìn, theo dõi, quan sát; sự canh gác, sự canh phòng
water t(n) nước
wavet(n) (v) sóng, gợn nước; gợn sóng, uốn thành sóng
wayt(n) đường, đường đi
weakt(adj) yếu, yếu ớt
weakness	t(n) tình trạng yếu đuối, yếu ớt
wealtht(n) sự giàu có, sự giàu sang
weapont(n) vũ khí
weart(v) mặc, mang, đeo
weather t(n) thời tiết
webt(n) mạng, lưới
website t(n) không gian liên tới với Internet
wedding t(n) lễ cưới, hôn lễ
wednesdayt(n) thứ 4
weekt(n) tuần, tuần lễ
weekend t(n) cuối tuần
weeklyt(adj) mỗi tuần một lần, hàng tuần
weigh t(v) cân, cân nặng
weightt(n) trọng lượng
welcome t(v) (adj) (n) chào mừng, hoan nghênh
wellt(adv) (adj) tốt, giỏi; ôi, may quá!
as well as tcũng, cũng như
westt(n) (adj) (adv) phía Tây, theo phía tây, về hướng tây
western t(adj) về phía tây, của phía tây
wett(adj) ướt, ẩm ướt
whatever	tpro (n) bất cứ thứ gì, bất kể thứ gì
wheel t(n) bánh xe
whenever	t(conj) bất cứ lúc nào, lúc nào
whereas t(conj) nhưng ngược lại, trong khi
wherever	t(conj) ở bất cứ nơi nào, ở bất cứ nơi đâu
whether t(conj) có..không; có... chăng; không biết có.. không
while t(conj) (n) trong lúc, trong khi; lúc, chốc, lát
whilstt(conj) trong lúc, trong khi
whisper t(v) (n) nói thì thầm, xì xào; tiếng nói thì thầm, tiếng xì xào
whistle t(n) (v) sự huýt sáo, sự thổi còi; huýt sáo, thổi còi
whoever tpro (n) ai, người nào, bất cứ ai, bất cứ người nào, dù ai
whole t(adj) (n) bình an vô sự, không suy suyển, không hư hỏng; toàn bộ, tất cả, toàn thể
white t(adj) (n) trắng; màu trắng
whose tpro (n) của ai
widet(adj) rộng, rộng lớn
widelyt(adv) nhiều, xa; rộng rãi
width t(n) tính chất rộng, bề rộng
wildt(adj) dại, hoang
wildlyt(adv) dại, hoang
willt(v) (n) sẽ; ý chí, ý định
willing t(adj) bằng lòng, vui lòng, muốn
willinglyt(adv) sẵn lòng, tự nguyện
unwillingt(adj) không muốn làm điều gì; miễn cưỡng; bất đắc dĩ
unwillinglyt(adv) miễn cưỡng; bất đắc dĩ
willingnesst(n) sự bằng lòng, sự vui lòng
wint(v) chiếm, đọat, thu được
winning t(adj) đang dành thắng lợi, thắng cuộc
windt(n) (v) gió, quấn lại, cuộn lại
wind sth uptlên dây, quấn, giải quyết
winet(n) rượu, đồ uống
wingt(n) cánh, sự bay, sự cất cánh
winnert(n) người thắng cuộc
wintert(n) mùa đông
wiret(n) dây (kim loại)
wiset(adj) khôn ngoan, sáng suốt, thông thái
wisht(v) (n) ước, mong muốn; sự mong ước, lòng mong muốn
witht(prep) với, cùng
withdraw	t(v) rút, rút khỏi, rút lui
withint(prep) trong vong thời gian, trong khoảng thời gian
without t(prep) không, không có
witness t(n) (v) sự làm chứng, bằng chứng; chứng kiến, làm chứng